기준연월,시군구코드,광역시도명,시군구명,5세단위구분,총인구수,남성인구수,여성인구수
202001,11110,서울특별시,종로구,0-4세,3527,1765,1762
202002,11110,서울특별시,종로구,0-4세,3498,1752,1746
202003,11110,서울특별시,종로구,0-4세,3441,1728,1713
202004,11110,서울특별시,종로구,0-4세,3402,1705,1697
202005,11110,서울특별시,종로구,0-4세,3368,1691,1677
202006,11110,서울특별시,종로구,0-4세,3346,1683,1663
202001,11110,서울특별시,종로구,5-9세,4655,2363,2292
202002,11110,서울특별시,종로구,5-9세,4632,2340,2292
202003,11110,서울특별시,종로구,5-9세,4618,2342,2276
202004,11110,서울특별시,종로구,5-9세,4606,2337,2269
202005,11110,서울특별시,종로구,5-9세,4580,2330,2250
202006,11110,서울특별시,종로구,5-9세,4550,2313,2237
202001,11110,서울특별시,종로구,10-14세,5170,2624,2546
202002,11110,서울특별시,종로구,10-14세,5150,2636,2514
202003,11110,서울특별시,종로구,10-14세,5124,2611,2513
202004,11110,서울특별시,종로구,10-14세,5084,2591,2493
202005,11110,서울특별시,종로구,10-14세,5087,2575,2512
202006,11110,서울특별시,종로구,10-14세,5091,2581,2510
202001,11110,서울특별시,종로구,15-19세,6544,3274,3270
202002,11110,서울특별시,종로구,15-19세,6502,3251,3251
202003,11110,서울특별시,종로구,15-19세,6446,3216,3230
202004,11110,서울특별시,종로구,15-19세,6395,3199,3196
202005,11110,서울특별시,종로구,15-19세,6281,3159,3122
202006,11110,서울특별시,종로구,15-19세,6218,3124,3094
202001,11110,서울특별시,종로구,20-24세,10850,5148,5702
202002,11110,서울특별시,종로구,20-24세,10838,5132,5706
202003,11110,서울특별시,종로구,20-24세,10887,5136,5751
202004,11110,서울특별시,종로구,20-24세,10830,5102,5728
202005,11110,서울특별시,종로구,20-24세,10785,5075,5710
202006,11110,서울특별시,종로구,20-24세,10710,5026,5684
202001,11110,서울특별시,종로구,25-29세,12592,6473,6119
202002,11110,서울특별시,종로구,25-29세,12598,6445,6153
202003,11110,서울특별시,종로구,25-29세,12585,6459,6126
202004,11110,서울특별시,종로구,25-29세,12615,6463,6152
202005,11110,서울특별시,종로구,25-29세,12647,6493,6154
202006,11110,서울특별시,종로구,25-29세,12736,6538,6198
202001,11110,서울특별시,종로구,30-34세,10142,5060,5082
202002,11110,서울특별시,종로구,30-34세,10094,5066,5028
202003,11110,서울특별시,종로구,30-34세,10090,5062,5028
202004,11110,서울특별시,종로구,30-34세,10123,5102,5021
202005,11110,서울특별시,종로구,30-34세,10129,5084,5045
202006,11110,서울특별시,종로구,30-34세,10106,5066,5040
202001,11110,서울특별시,종로구,35-39세,10214,5021,5193
202002,11110,서울특별시,종로구,35-39세,10231,5015,5216
202003,11110,서울특별시,종로구,35-39세,10200,4994,5206
202004,11110,서울특별시,종로구,35-39세,10112,4978,5134
202005,11110,서울특별시,종로구,35-39세,10046,4949,5097
202006,11110,서울특별시,종로구,35-39세,10040,4957,5083
202001,11110,서울특별시,종로구,40-44세,9973,4800,5173
202002,11110,서울특별시,종로구,40-44세,9963,4813,5150
202003,11110,서울특별시,종로구,40-44세,9908,4796,5112
202004,11110,서울특별시,종로구,40-44세,9929,4782,5147
202005,11110,서울특별시,종로구,40-44세,9895,4749,5146
202006,11110,서울특별시,종로구,40-44세,9888,4734,5154
202001,11110,서울특별시,종로구,45-49세,13057,6390,6667
202002,11110,서울특별시,종로구,45-49세,13088,6413,6675
202003,11110,서울특별시,종로구,45-49세,13027,6383,6644
202004,11110,서울특별시,종로구,45-49세,12919,6334,6585
202005,11110,서울특별시,종로구,45-49세,12825,6301,6524
202006,11110,서울특별시,종로구,45-49세,12753,6275,6478
202001,11110,서울특별시,종로구,50-54세,12821,6383,6438
202002,11110,서울특별시,종로구,50-54세,12812,6365,6447
202003,11110,서울특별시,종로구,50-54세,12835,6385,6450
202004,11110,서울특별시,종로구,50-54세,12853,6381,6472
202005,11110,서울특별시,종로구,50-54세,12905,6397,6508
202006,11110,서울특별시,종로구,50-54세,12886,6382,6504
202001,11110,서울특별시,종로구,55-59세,12889,6553,6336
202002,11110,서울특별시,종로구,55-59세,12891,6554,6337
202003,11110,서울특별시,종로구,55-59세,12901,6550,6351
202004,11110,서울특별시,종로구,55-59세,12874,6552,6322
202005,11110,서울특별시,종로구,55-59세,12858,6550,6308
202006,11110,서울특별시,종로구,55-59세,12776,6525,6251
202001,11110,서울특별시,종로구,60-64세,11279,5693,5586
202002,11110,서울특별시,종로구,60-64세,11362,5710,5652
202003,11110,서울특별시,종로구,60-64세,11300,5707,5593
202004,11110,서울특별시,종로구,60-64세,11297,5693,5604
202005,11110,서울특별시,종로구,60-64세,11293,5697,5596
202006,11110,서울특별시,종로구,60-64세,11297,5685,5612
202001,11110,서울특별시,종로구,65-69세,7957,3847,4110
202002,11110,서울특별시,종로구,65-69세,8021,3895,4126
202003,11110,서울특별시,종로구,65-69세,8189,3976,4213
202004,11110,서울특별시,종로구,65-69세,8196,3967,4229
202005,11110,서울특별시,종로구,65-69세,8217,3980,4237
202006,11110,서울특별시,종로구,65-69세,8259,4005,4254
202001,11110,서울특별시,종로구,70-74세,6722,2994,3728
202002,11110,서울특별시,종로구,70-74세,6729,3009,3720
202003,11110,서울특별시,종로구,70-74세,6720,3014,3706
202004,11110,서울특별시,종로구,70-74세,6708,3014,3694
202005,11110,서울특별시,종로구,70-74세,6672,3005,3667
202006,11110,서울특별시,종로구,70-74세,6681,3015,3666
202001,11110,서울특별시,종로구,75-79세,5841,2576,3265
202002,11110,서울특별시,종로구,75-79세,5868,2592,3276
202003,11110,서울특별시,종로구,75-79세,5860,2585,3275
202004,11110,서울특별시,종로구,75-79세,5871,2583,3288
202005,11110,서울특별시,종로구,75-79세,5899,2595,3304
202006,11110,서울특별시,종로구,75-79세,5914,2597,3317
202001,11110,서울특별시,종로구,80-84세,3859,1598,2261
202002,11110,서울특별시,종로구,80-84세,3854,1591,2263
202003,11110,서울특별시,종로구,80-84세,3894,1613,2281
202004,11110,서울특별시,종로구,80-84세,3916,1624,2292
202005,11110,서울특별시,종로구,80-84세,3903,1614,2289
202006,11110,서울특별시,종로구,80-84세,3892,1612,2280
202001,11110,서울특별시,종로구,85-89세,1846,685,1161
202002,11110,서울특별시,종로구,85-89세,1893,707,1186
202003,11110,서울특별시,종로구,85-89세,1898,699,1199
202004,11110,서울특별시,종로구,85-89세,1898,706,1192
202005,11110,서울특별시,종로구,85-89세,1922,711,1211
202006,11110,서울특별시,종로구,85-89세,1920,710,1210
202001,11110,서울특별시,종로구,90-94세,741,243,498
202002,11110,서울특별시,종로구,90-94세,744,244,500
202003,11110,서울특별시,종로구,90-94세,753,249,504
202004,11110,서울특별시,종로구,90-94세,760,248,512
202005,11110,서울특별시,종로구,90-94세,761,247,514
202006,11110,서울특별시,종로구,90-94세,770,255,515
202001,11110,서울특별시,종로구,95-99세,277,113,164
202002,11110,서울특별시,종로구,95-99세,282,114,168
202003,11110,서울특별시,종로구,95-99세,280,113,167
202004,11110,서울특별시,종로구,95-99세,285,115,170
202005,11110,서울특별시,종로구,95-99세,283,117,166
202006,11110,서울특별시,종로구,95-99세,283,117,166
202001,11110,서울특별시,종로구,100+,259,85,174
202002,11110,서울특별시,종로구,100+,259,85,174
202003,11110,서울특별시,종로구,100+,261,86,175
202004,11110,서울특별시,종로구,100+,263,87,176
202005,11110,서울특별시,종로구,100+,267,88,179
202006,11110,서울특별시,종로구,100+,267,88,179
202001,11140,서울특별시,중구,0-4세,3646,1856,1790
202002,11140,서울특별시,중구,0-4세,3619,1835,1784
202003,11140,서울특별시,중구,0-4세,3561,1806,1755
202004,11140,서울특별시,중구,0-4세,3507,1775,1732
202005,11140,서울특별시,중구,0-4세,3469,1754,1715
202006,11140,서울특별시,중구,0-4세,3449,1745,1704
202001,11140,서울특별시,중구,5-9세,3700,1886,1814
202002,11140,서울특별시,중구,5-9세,3642,1859,1783
202003,11140,서울특별시,중구,5-9세,3632,1846,1786
202004,11140,서울특별시,중구,5-9세,3644,1852,1792
202005,11140,서울특별시,중구,5-9세,3644,1856,1788
202006,11140,서울특별시,중구,5-9세,3648,1856,1792
202001,11140,서울특별시,중구,10-14세,3170,1581,1589
202002,11140,서울특별시,중구,10-14세,3120,1548,1572
202003,11140,서울특별시,중구,10-14세,3096,1545,1551
202004,11140,서울특별시,중구,10-14세,3110,1549,1561
202005,11140,서울특별시,중구,10-14세,3120,1563,1557
202006,11140,서울특별시,중구,10-14세,3108,1550,1558
202001,11140,서울특별시,중구,15-19세,4124,2128,1996
202002,11140,서울특별시,중구,15-19세,4161,2129,2032
202003,11140,서울특별시,중구,15-19세,4165,2103,2062
202004,11140,서울특별시,중구,15-19세,4115,2075,2040
202005,11140,서울특별시,중구,15-19세,4068,2046,2022
202006,11140,서울특별시,중구,15-19세,4023,2021,2002
202001,11140,서울특별시,중구,20-24세,7646,3590,4056
202002,11140,서울특별시,중구,20-24세,7707,3622,4085
202003,11140,서울특별시,중구,20-24세,7733,3615,4118
202004,11140,서울특별시,중구,20-24세,7779,3623,4156
202005,11140,서울특별시,중구,20-24세,7798,3626,4172
202006,11140,서울특별시,중구,20-24세,7784,3616,4168
202001,11140,서울특별시,중구,25-29세,10819,5352,5467
202002,11140,서울특별시,중구,25-29세,10785,5341,5444
202003,11140,서울특별시,중구,25-29세,10802,5344,5458
202004,11140,서울특별시,중구,25-29세,10763,5306,5457
202005,11140,서울특별시,중구,25-29세,10766,5295,5471
202006,11140,서울특별시,중구,25-29세,10781,5295,5486
202001,11140,서울특별시,중구,30-34세,10193,5098,5095
202002,11140,서울특별시,중구,30-34세,10196,5108,5088
202003,11140,서울특별시,중구,30-34세,10192,5082,5110
202004,11140,서울특별시,중구,30-34세,10145,5051,5094
202005,11140,서울특별시,중구,30-34세,10156,5046,5110
202006,11140,서울특별시,중구,30-34세,10186,5052,5134
202001,11140,서울특별시,중구,35-39세,10382,5207,5175
202002,11140,서울특별시,중구,35-39세,10314,5182,5132
202003,11140,서울특별시,중구,35-39세,10226,5149,5077
202004,11140,서울특별시,중구,35-39세,10239,5158,5081
202005,11140,서울특별시,중구,35-39세,10200,5162,5038
202006,11140,서울특별시,중구,35-39세,10207,5167,5040
202001,11140,서울특별시,중구,40-44세,8719,4519,4200
202002,11140,서울특별시,중구,40-44세,8744,4545,4199
202003,11140,서울특별시,중구,40-44세,8732,4519,4213
202004,11140,서울특별시,중구,40-44세,8712,4503,4209
202005,11140,서울특별시,중구,40-44세,8740,4507,4233
202006,11140,서울특별시,중구,40-44세,8717,4501,4216
202001,11140,서울특별시,중구,45-49세,9832,4931,4901
202002,11140,서울특별시,중구,45-49세,9829,4916,4913
202003,11140,서울특별시,중구,45-49세,9775,4910,4865
202004,11140,서울특별시,중구,45-49세,9745,4907,4838
202005,11140,서울특별시,중구,45-49세,9713,4881,4832
202006,11140,서울특별시,중구,45-49세,9671,4850,4821
202001,11140,서울특별시,중구,50-54세,10235,5228,5007
202002,11140,서울특별시,중구,50-54세,10259,5247,5012
202003,11140,서울특별시,중구,50-54세,10274,5242,5032
202004,11140,서울특별시,중구,50-54세,10312,5265,5047
202005,11140,서울특별시,중구,50-54세,10314,5274,5040
202006,11140,서울특별시,중구,50-54세,10339,5292,5047
202001,11140,서울특별시,중구,55-59세,10697,5421,5276
202002,11140,서울특별시,중구,55-59세,10723,5426,5297
202003,11140,서울특별시,중구,55-59세,10708,5427,5281
202004,11140,서울특별시,중구,55-59세,10678,5413,5265
202005,11140,서울특별시,중구,55-59세,10659,5404,5255
202006,11140,서울특별시,중구,55-59세,10600,5371,5229
202001,11140,서울특별시,중구,60-64세,9923,4989,4934
202002,11140,서울특별시,중구,60-64세,9903,4985,4918
202003,11140,서울특별시,중구,60-64세,9831,4948,4883
202004,11140,서울특별시,중구,60-64세,9852,4947,4905
202005,11140,서울특별시,중구,60-64세,9853,4944,4909
202006,11140,서울특별시,중구,60-64세,9884,4970,4914
202001,11140,서울특별시,중구,65-69세,7093,3497,3596
202002,11140,서울특별시,중구,65-69세,7167,3523,3644
202003,11140,서울특별시,중구,65-69세,7283,3565,3718
202004,11140,서울특별시,중구,65-69세,7286,3570,3716
202005,11140,서울특별시,중구,65-69세,7310,3588,3722
202006,11140,서울특별시,중구,65-69세,7344,3598,3746
202001,11140,서울특별시,중구,70-74세,5697,2595,3102
202002,11140,서울특별시,중구,70-74세,5699,2597,3102
202003,11140,서울특별시,중구,70-74세,5729,2610,3119
202004,11140,서울특별시,중구,70-74세,5738,2620,3118
202005,11140,서울특별시,중구,70-74세,5775,2636,3139
202006,11140,서울특별시,중구,70-74세,5761,2621,3140
202001,11140,서울특별시,중구,75-79세,4710,2056,2654
202002,11140,서울특별시,중구,75-79세,4721,2074,2647
202003,11140,서울특별시,중구,75-79세,4742,2096,2646
202004,11140,서울특별시,중구,75-79세,4778,2111,2667
202005,11140,서울특별시,중구,75-79세,4795,2108,2687
202006,11140,서울특별시,중구,75-79세,4840,2129,2711
202001,11140,서울특별시,중구,80-84세,3065,1213,1852
202002,11140,서울특별시,중구,80-84세,3106,1215,1891
202003,11140,서울특별시,중구,80-84세,3115,1214,1901
202004,11140,서울특별시,중구,80-84세,3121,1221,1900
202005,11140,서울특별시,중구,80-84세,3131,1236,1895
202006,11140,서울특별시,중구,80-84세,3135,1244,1891
202001,11140,서울특별시,중구,85-89세,1515,479,1036
202002,11140,서울특별시,중구,85-89세,1521,491,1030
202003,11140,서울특별시,중구,85-89세,1533,494,1039
202004,11140,서울특별시,중구,85-89세,1549,500,1049
202005,11140,서울특별시,중구,85-89세,1555,494,1061
202006,11140,서울특별시,중구,85-89세,1560,495,1065
202001,11140,서울특별시,중구,90-94세,642,200,442
202002,11140,서울특별시,중구,90-94세,651,202,449
202003,11140,서울특별시,중구,90-94세,652,205,447
202004,11140,서울특별시,중구,90-94세,653,204,449
202005,11140,서울특별시,중구,90-94세,657,206,451
202006,11140,서울특별시,중구,90-94세,660,204,456
202001,11140,서울특별시,중구,95-99세,199,55,144
202002,11140,서울특별시,중구,95-99세,197,54,143
202003,11140,서울특별시,중구,95-99세,199,55,144
202004,11140,서울특별시,중구,95-99세,203,56,147
202005,11140,서울특별시,중구,95-99세,201,57,144
202006,11140,서울특별시,중구,95-99세,198,56,142
202001,11140,서울특별시,중구,100+,194,65,129
202002,11140,서울특별시,중구,100+,195,65,130
202003,11140,서울특별시,중구,100+,195,64,131
202004,11140,서울특별시,중구,100+,197,64,133
202005,11140,서울특별시,중구,100+,196,64,132
202006,11140,서울특별시,중구,100+,197,64,133
202001,11170,서울특별시,용산구,0-4세,6801,3528,3273
202002,11170,서울특별시,용산구,0-4세,6758,3505,3253
202003,11170,서울특별시,용산구,0-4세,6729,3496,3233
202004,11170,서울특별시,용산구,0-4세,6690,3482,3208
202005,11170,서울특별시,용산구,0-4세,6650,3474,3176
202006,11170,서울특별시,용산구,0-4세,6581,3439,3142
202001,11170,서울특별시,용산구,5-9세,7326,3779,3547
202002,11170,서울특별시,용산구,5-9세,7335,3789,3546
202003,11170,서울특별시,용산구,5-9세,7325,3773,3552
202004,11170,서울특별시,용산구,5-9세,7319,3766,3553
202005,11170,서울특별시,용산구,5-9세,7318,3757,3561
202006,11170,서울특별시,용산구,5-9세,7330,3756,3574
202001,11170,서울특별시,용산구,10-14세,7326,3714,3612
202002,11170,서울특별시,용산구,10-14세,7255,3668,3587
202003,11170,서울특별시,용산구,10-14세,7238,3632,3606
202004,11170,서울특별시,용산구,10-14세,7215,3610,3605
202005,11170,서울특별시,용산구,10-14세,7216,3620,3596
202006,11170,서울특별시,용산구,10-14세,7212,3633,3579
202001,11170,서울특별시,용산구,15-19세,9069,4676,4393
202002,11170,서울특별시,용산구,15-19세,9059,4667,4392
202003,11170,서울특별시,용산구,15-19세,8981,4625,4356
202004,11170,서울특별시,용산구,15-19세,8887,4578,4309
202005,11170,서울특별시,용산구,15-19세,8795,4522,4273
202006,11170,서울특별시,용산구,15-19세,8752,4481,4271
202001,11170,서울특별시,용산구,20-24세,13776,6497,7279
202002,11170,서울특별시,용산구,20-24세,13809,6478,7331
202003,11170,서울특별시,용산구,20-24세,13806,6474,7332
202004,11170,서울특별시,용산구,20-24세,13786,6472,7314
202005,11170,서울특별시,용산구,20-24세,13780,6457,7323
202006,11170,서울특별시,용산구,20-24세,13806,6486,7320
202001,11170,서울특별시,용산구,25-29세,19215,9368,9847
202002,11170,서울특별시,용산구,25-29세,19227,9378,9849
202003,11170,서울특별시,용산구,25-29세,19322,9385,9937
202004,11170,서울특별시,용산구,25-29세,19383,9428,9955
202005,11170,서울특별시,용산구,25-29세,19410,9404,10006
202006,11170,서울특별시,용산구,25-29세,19461,9416,10045
202001,11170,서울특별시,용산구,30-34세,18635,9241,9394
202002,11170,서울특별시,용산구,30-34세,18782,9310,9472
202003,11170,서울특별시,용산구,30-34세,18756,9311,9445
202004,11170,서울특별시,용산구,30-34세,18749,9306,9443
202005,11170,서울특별시,용산구,30-34세,18836,9354,9482
202006,11170,서울특별시,용산구,30-34세,18872,9355,9517
202001,11170,서울특별시,용산구,35-39세,19451,9760,9691
202002,11170,서울특별시,용산구,35-39세,19415,9718,9697
202003,11170,서울특별시,용산구,35-39세,19390,9702,9688
202004,11170,서울특별시,용산구,35-39세,19315,9684,9631
202005,11170,서울특별시,용산구,35-39세,19293,9649,9644
202006,11170,서울특별시,용산구,35-39세,19252,9641,9611
202001,11170,서울특별시,용산구,40-44세,16613,8164,8449
202002,11170,서울특별시,용산구,40-44세,16665,8204,8461
202003,11170,서울특별시,용산구,40-44세,16667,8221,8446
202004,11170,서울특별시,용산구,40-44세,16643,8178,8465
202005,11170,서울특별시,용산구,40-44세,16665,8196,8469
202006,11170,서울특별시,용산구,40-44세,16704,8201,8503
202001,11170,서울특별시,용산구,45-49세,19650,9694,9956
202002,11170,서울특별시,용산구,45-49세,19568,9645,9923
202003,11170,서울특별시,용산구,45-49세,19459,9569,9890
202004,11170,서울특별시,용산구,45-49세,19399,9556,9843
202005,11170,서울특별시,용산구,45-49세,19293,9495,9798
202006,11170,서울특별시,용산구,45-49세,19230,9450,9780
202001,11170,서울특별시,용산구,50-54세,18557,9161,9396
202002,11170,서울특별시,용산구,50-54세,18640,9210,9430
202003,11170,서울특별시,용산구,50-54세,18652,9198,9454
202004,11170,서울특별시,용산구,50-54세,18666,9199,9467
202005,11170,서울특별시,용산구,50-54세,18696,9213,9483
202006,11170,서울특별시,용산구,50-54세,18709,9239,9470
202001,11170,서울특별시,용산구,55-59세,18038,8942,9096
202002,11170,서울특별시,용산구,55-59세,18048,8925,9123
202003,11170,서울특별시,용산구,55-59세,18007,8950,9057
202004,11170,서울특별시,용산구,55-59세,18003,8955,9048
202005,11170,서울특별시,용산구,55-59세,18004,8970,9034
202006,11170,서울특별시,용산구,55-59세,17949,8945,9004
202001,11170,서울특별시,용산구,60-64세,16330,7860,8470
202002,11170,서울특별시,용산구,60-64세,16373,7906,8467
202003,11170,서울특별시,용산구,60-64세,16300,7876,8424
202004,11170,서울특별시,용산구,60-64세,16297,7888,8409
202005,11170,서울특별시,용산구,60-64세,16314,7880,8434
202006,11170,서울특별시,용산구,60-64세,16408,7919,8489
202001,11170,서울특별시,용산구,65-69세,11269,5234,6035
202002,11170,서울특별시,용산구,65-69세,11343,5259,6084
202003,11170,서울특별시,용산구,65-69세,11508,5332,6176
202004,11170,서울특별시,용산구,65-69세,11566,5372,6194
202005,11170,서울특별시,용산구,65-69세,11605,5386,6219
202006,11170,서울특별시,용산구,65-69세,11642,5398,6244
202001,11170,서울특별시,용산구,70-74세,9277,4062,5215
202002,11170,서울특별시,용산구,70-74세,9292,4079,5213
202003,11170,서울특별시,용산구,70-74세,9306,4079,5227
202004,11170,서울특별시,용산구,70-74세,9286,4077,5209
202005,11170,서울특별시,용산구,70-74세,9300,4081,5219
202006,11170,서울특별시,용산구,70-74세,9307,4093,5214
202001,11170,서울특별시,용산구,75-79세,7915,3373,4542
202002,11170,서울특별시,용산구,75-79세,7915,3371,4544
202003,11170,서울특별시,용산구,75-79세,7890,3374,4516
202004,11170,서울특별시,용산구,75-79세,7892,3369,4523
202005,11170,서울특별시,용산구,75-79세,7905,3377,4528
202006,11170,서울특별시,용산구,75-79세,7895,3366,4529
202001,11170,서울특별시,용산구,80-84세,5559,2116,3443
202002,11170,서울특별시,용산구,80-84세,5566,2107,3459
202003,11170,서울특별시,용산구,80-84세,5573,2094,3479
202004,11170,서울특별시,용산구,80-84세,5570,2094,3476
202005,11170,서울특별시,용산구,80-84세,5590,2109,3481
202006,11170,서울특별시,용산구,80-84세,5583,2114,3469
202001,11170,서울특별시,용산구,85-89세,2687,951,1736
202002,11170,서울특별시,용산구,85-89세,2710,961,1749
202003,11170,서울특별시,용산구,85-89세,2736,977,1759
202004,11170,서울특별시,용산구,85-89세,2766,988,1778
202005,11170,서울특별시,용산구,85-89세,2791,995,1796
202006,11170,서울특별시,용산구,85-89세,2793,991,1802
202001,11170,서울특별시,용산구,90-94세,1132,325,807
202002,11170,서울특별시,용산구,90-94세,1144,331,813
202003,11170,서울특별시,용산구,90-94세,1151,333,818
202004,11170,서울특별시,용산구,90-94세,1153,334,819
202005,11170,서울특별시,용산구,90-94세,1157,335,822
202006,11170,서울특별시,용산구,90-94세,1165,338,827
202001,11170,서울특별시,용산구,95-99세,402,157,245
202002,11170,서울특별시,용산구,95-99세,411,160,251
202003,11170,서울특별시,용산구,95-99세,420,162,258
202004,11170,서울특별시,용산구,95-99세,419,163,256
202005,11170,서울특별시,용산구,95-99세,410,158,252
202006,11170,서울특별시,용산구,95-99세,417,162,255
202001,11170,서울특별시,용산구,100+,357,99,258
202002,11170,서울특별시,용산구,100+,362,102,260
202003,11170,서울특별시,용산구,100+,363,104,259
202004,11170,서울특별시,용산구,100+,365,105,260
202005,11170,서울특별시,용산구,100+,365,105,260
202006,11170,서울특별시,용산구,100+,363,104,259
202001,11200,서울특별시,성동구,0-4세,11055,5690,5365
202002,11200,서울특별시,성동구,0-4세,10937,5624,5313
202003,11200,서울특별시,성동구,0-4세,10762,5533,5229
202004,11200,서울특별시,성동구,0-4세,10638,5485,5153
202005,11200,서울특별시,성동구,0-4세,10578,5443,5135
202006,11200,서울특별시,성동구,0-4세,10526,5414,5112
202001,11200,서울특별시,성동구,5-9세,10760,5476,5284
202002,11200,서울특별시,성동구,5-9세,10604,5391,5213
202003,11200,서울특별시,성동구,5-9세,10602,5377,5225
202004,11200,서울특별시,성동구,5-9세,10597,5359,5238
202005,11200,서울특별시,성동구,5-9세,10555,5358,5197
202006,11200,서울특별시,성동구,5-9세,10583,5364,5219
202001,11200,서울특별시,성동구,10-14세,9528,4853,4675
202002,11200,서울특별시,성동구,10-14세,9458,4825,4633
202003,11200,서울특별시,성동구,10-14세,9430,4846,4584
202004,11200,서울특별시,성동구,10-14세,9398,4829,4569
202005,11200,서울특별시,성동구,10-14세,9397,4809,4588
202006,11200,서울특별시,성동구,10-14세,9379,4815,4564
202001,11200,서울특별시,성동구,15-19세,11774,5795,5979
202002,11200,서울특별시,성동구,15-19세,11765,5769,5996
202003,11200,서울특별시,성동구,15-19세,11712,5745,5967
202004,11200,서울특별시,성동구,15-19세,11611,5692,5919
202005,11200,서울특별시,성동구,15-19세,11514,5633,5881
202006,11200,서울특별시,성동구,15-19세,11422,5581,5841
202001,11200,서울특별시,성동구,20-24세,20282,9871,10411
202002,11200,서울특별시,성동구,20-24세,20262,9900,10362
202003,11200,서울특별시,성동구,20-24세,20223,9852,10371
202004,11200,서울특별시,성동구,20-24세,20154,9810,10344
202005,11200,서울특별시,성동구,20-24세,20170,9790,10380
202006,11200,서울특별시,성동구,20-24세,20171,9766,10405
202001,11200,서울특별시,성동구,25-29세,25609,12867,12742
202002,11200,서울특별시,성동구,25-29세,25461,12778,12683
202003,11200,서울특별시,성동구,25-29세,25501,12831,12670
202004,11200,서울특별시,성동구,25-29세,25440,12798,12642
202005,11200,서울특별시,성동구,25-29세,25426,12824,12602
202006,11200,서울특별시,성동구,25-29세,25458,12805,12653
202001,11200,서울특별시,성동구,30-34세,24275,11657,12618
202002,11200,서울특별시,성동구,30-34세,24222,11622,12600
202003,11200,서울특별시,성동구,30-34세,24164,11605,12559
202004,11200,서울특별시,성동구,30-34세,24179,11617,12562
202005,11200,서울특별시,성동구,30-34세,24184,11586,12598
202006,11200,서울특별시,성동구,30-34세,24125,11539,12586
202001,11200,서울특별시,성동구,35-39세,26448,13343,13105
202002,11200,서울특별시,성동구,35-39세,26295,13283,13012
202003,11200,서울특별시,성동구,35-39세,26079,13133,12946
202004,11200,서울특별시,성동구,35-39세,25948,13027,12921
202005,11200,서울특별시,성동구,35-39세,25833,12971,12862
202006,11200,서울특별시,성동구,35-39세,25757,12959,12798
202001,11200,서울특별시,성동구,40-44세,22276,11261,11015
202002,11200,서울특별시,성동구,40-44세,22255,11256,10999
202003,11200,서울특별시,성동구,40-44세,22153,11226,10927
202004,11200,서울특별시,성동구,40-44세,22017,11165,10852
202005,11200,서울특별시,성동구,40-44세,21969,11156,10813
202006,11200,서울특별시,성동구,40-44세,22006,11154,10852
202001,11200,서울특별시,성동구,45-49세,24810,12383,12427
202002,11200,서울특별시,성동구,45-49세,24671,12256,12415
202003,11200,서울특별시,성동구,45-49세,24494,12159,12335
202004,11200,서울특별시,성동구,45-49세,24335,12089,12246
202005,11200,서울특별시,성동구,45-49세,24189,12000,12189
202006,11200,서울특별시,성동구,45-49세,24013,11915,12098
202001,11200,서울특별시,성동구,50-54세,24236,12004,12232
202002,11200,서울특별시,성동구,50-54세,24284,12070,12214
202003,11200,서울특별시,성동구,50-54세,24238,12039,12199
202004,11200,서울특별시,성동구,50-54세,24225,11995,12230
202005,11200,서울특별시,성동구,50-54세,24194,11983,12211
202006,11200,서울특별시,성동구,50-54세,24214,11983,12231
202001,11200,서울특별시,성동구,55-59세,24167,12198,11969
202002,11200,서울특별시,성동구,55-59세,24146,12198,11948
202003,11200,서울특별시,성동구,55-59세,24034,12124,11910
202004,11200,서울특별시,성동구,55-59세,23926,12066,11860
202005,11200,서울특별시,성동구,55-59세,23906,12060,11846
202006,11200,서울특별시,성동구,55-59세,23677,11928,11749
202001,11200,서울특별시,성동구,60-64세,21137,10423,10714
202002,11200,서울특별시,성동구,60-64세,21188,10435,10753
202003,11200,서울특별시,성동구,60-64세,21103,10406,10697
202004,11200,서울특별시,성동구,60-64세,21124,10417,10707
202005,11200,서울특별시,성동구,60-64세,21136,10432,10704
202006,11200,서울특별시,성동구,60-64세,21240,10485,10755
202001,11200,서울특별시,성동구,65-69세,14170,6711,7459
202002,11200,서울특별시,성동구,65-69세,14278,6745,7533
202003,11200,서울특별시,성동구,65-69세,14482,6851,7631
202004,11200,서울특별시,성동구,65-69세,14544,6893,7651
202005,11200,서울특별시,성동구,65-69세,14552,6872,7680
202006,11200,서울특별시,성동구,65-69세,14571,6879,7692
202001,11200,서울특별시,성동구,70-74세,11301,5080,6221
202002,11200,서울특별시,성동구,70-74세,11328,5110,6218
202003,11200,서울특별시,성동구,70-74세,11328,5114,6214
202004,11200,서울특별시,성동구,70-74세,11302,5099,6203
202005,11200,서울특별시,성동구,70-74세,11335,5134,6201
202006,11200,서울특별시,성동구,70-74세,11341,5148,6193
202001,11200,서울특별시,성동구,75-79세,9160,4022,5138
202002,11200,서울특별시,성동구,75-79세,9138,4003,5135
202003,11200,서울특별시,성동구,75-79세,9165,4021,5144
202004,11200,서울특별시,성동구,75-79세,9194,4037,5157
202005,11200,서울특별시,성동구,75-79세,9216,4045,5171
202006,11200,서울특별시,성동구,75-79세,9231,4038,5193
202001,11200,서울특별시,성동구,80-84세,5613,2212,3401
202002,11200,서울특별시,성동구,80-84세,5661,2231,3430
202003,11200,서울특별시,성동구,80-84세,5687,2237,3450
202004,11200,서울특별시,성동구,80-84세,5668,2224,3444
202005,11200,서울특별시,성동구,80-84세,5695,2228,3467
202006,11200,서울특별시,성동구,80-84세,5707,2238,3469
202001,11200,서울특별시,성동구,85-89세,2469,804,1665
202002,11200,서울특별시,성동구,85-89세,2489,814,1675
202003,11200,서울특별시,성동구,85-89세,2512,821,1691
202004,11200,서울특별시,성동구,85-89세,2576,852,1724
202005,11200,서울특별시,성동구,85-89세,2577,859,1718
202006,11200,서울특별시,성동구,85-89세,2588,865,1723
202001,11200,서울특별시,성동구,90-94세,872,234,638
202002,11200,서울특별시,성동구,90-94세,884,242,642
202003,11200,서울특별시,성동구,90-94세,895,240,655
202004,11200,서울특별시,성동구,90-94세,896,240,656
202005,11200,서울특별시,성동구,90-94세,915,245,670
202006,11200,서울특별시,성동구,90-94세,910,242,668
202001,11200,서울특별시,성동구,95-99세,233,71,162
202002,11200,서울특별시,성동구,95-99세,236,71,165
202003,11200,서울특별시,성동구,95-99세,240,73,167
202004,11200,서울특별시,성동구,95-99세,239,72,167
202005,11200,서울특별시,성동구,95-99세,240,71,169
202006,11200,서울특별시,성동구,95-99세,237,71,166
202001,11200,서울특별시,성동구,100+,235,65,170
202002,11200,서울특별시,성동구,100+,235,65,170
202003,11200,서울특별시,성동구,100+,238,67,171
202004,11200,서울특별시,성동구,100+,238,67,171
202005,11200,서울특별시,성동구,100+,239,68,171
202006,11200,서울특별시,성동구,100+,241,69,172
202001,11215,서울특별시,광진구,0-4세,9739,4974,4765
202002,11215,서울특별시,광진구,0-4세,9597,4906,4691
202003,11215,서울특별시,광진구,0-4세,9440,4803,4637
202004,11215,서울특별시,광진구,0-4세,9274,4713,4561
202005,11215,서울특별시,광진구,0-4세,9174,4666,4508
202006,11215,서울특별시,광진구,0-4세,9071,4622,4449
202001,11215,서울특별시,광진구,5-9세,11745,6044,5701
202002,11215,서울특별시,광진구,5-9세,11717,6007,5710
202003,11215,서울특별시,광진구,5-9세,11616,5935,5681
202004,11215,서울특별시,광진구,5-9세,11596,5897,5699
202005,11215,서울특별시,광진구,5-9세,11600,5912,5688
202006,11215,서울특별시,광진구,5-9세,11568,5900,5668
202001,11215,서울특별시,광진구,10-14세,12303,6295,6008
202002,11215,서울특별시,광진구,10-14세,12246,6270,5976
202003,11215,서울특별시,광진구,10-14세,12199,6276,5923
202004,11215,서울특별시,광진구,10-14세,12172,6266,5906
202005,11215,서울특별시,광진구,10-14세,12167,6263,5904
202006,11215,서울특별시,광진구,10-14세,12167,6260,5907
202001,11215,서울특별시,광진구,15-19세,15079,7686,7393
202002,11215,서울특별시,광진구,15-19세,15000,7619,7381
202003,11215,서울특별시,광진구,15-19세,14947,7553,7394
202004,11215,서울특별시,광진구,15-19세,14848,7486,7362
202005,11215,서울특별시,광진구,15-19세,14636,7385,7251
202006,11215,서울특별시,광진구,15-19세,14519,7320,7199
202001,11215,서울특별시,광진구,20-24세,26231,12057,14174
202002,11215,서울특별시,광진구,20-24세,26389,12140,14249
202003,11215,서울특별시,광진구,20-24세,26448,12198,14250
202004,11215,서울특별시,광진구,20-24세,26529,12211,14318
202005,11215,서울특별시,광진구,20-24세,26661,12251,14410
202006,11215,서울특별시,광진구,20-24세,26584,12223,14361
202001,11215,서울특별시,광진구,25-29세,35605,17294,18311
202002,11215,서울특별시,광진구,25-29세,35501,17227,18274
202003,11215,서울특별시,광진구,25-29세,35696,17229,18467
202004,11215,서울특별시,광진구,25-29세,35710,17199,18511
202005,11215,서울특별시,광진구,25-29세,35789,17250,18539
202006,11215,서울특별시,광진구,25-29세,35984,17320,18664
202001,11215,서울특별시,광진구,30-34세,29693,14627,15066
202002,11215,서울특별시,광진구,30-34세,29622,14594,15028
202003,11215,서울특별시,광진구,30-34세,29556,14580,14976
202004,11215,서울특별시,광진구,30-34세,29569,14564,15005
202005,11215,서울특별시,광진구,30-34세,29558,14552,15006
202006,11215,서울특별시,광진구,30-34세,29562,14539,15023
202001,11215,서울특별시,광진구,35-39세,28442,14142,14300
202002,11215,서울특별시,광진구,35-39세,28221,13997,14224
202003,11215,서울특별시,광진구,35-39세,27947,13850,14097
202004,11215,서울특별시,광진구,35-39세,27802,13783,14019
202005,11215,서울특별시,광진구,35-39세,27714,13729,13985
202006,11215,서울특별시,광진구,35-39세,27603,13671,13932
202001,11215,서울특별시,광진구,40-44세,25274,12529,12745
202002,11215,서울특별시,광진구,40-44세,25400,12633,12767
202003,11215,서울특별시,광진구,40-44세,25187,12508,12679
202004,11215,서울특별시,광진구,40-44세,25091,12453,12638
202005,11215,서울특별시,광진구,40-44세,25091,12455,12636
202006,11215,서울특별시,광진구,40-44세,25056,12421,12635
202001,11215,서울특별시,광진구,45-49세,29144,14311,14833
202002,11215,서울특별시,광진구,45-49세,29067,14286,14781
202003,11215,서울특별시,광진구,45-49세,28950,14249,14701
202004,11215,서울특별시,광진구,45-49세,28819,14191,14628
202005,11215,서울특별시,광진구,45-49세,28658,14083,14575
202006,11215,서울특별시,광진구,45-49세,28507,14018,14489
202001,11215,서울특별시,광진구,50-54세,28249,13701,14548
202002,11215,서울특별시,광진구,50-54세,28224,13650,14574
202003,11215,서울특별시,광진구,50-54세,28121,13594,14527
202004,11215,서울특별시,광진구,50-54세,28143,13587,14556
202005,11215,서울특별시,광진구,50-54세,28122,13586,14536
202006,11215,서울특별시,광진구,50-54세,28201,13609,14592
202001,11215,서울특별시,광진구,55-59세,27341,13409,13932
202002,11215,서울특별시,광진구,55-59세,27299,13437,13862
202003,11215,서울특별시,광진구,55-59세,27221,13451,13770
202004,11215,서울특별시,광진구,55-59세,27135,13397,13738
202005,11215,서울특별시,광진구,55-59세,27114,13368,13746
202006,11215,서울특별시,광진구,55-59세,26868,13246,13622
202001,11215,서울특별시,광진구,60-64세,24415,11678,12737
202002,11215,서울특별시,광진구,60-64세,24478,11696,12782
202003,11215,서울특별시,광진구,60-64세,24368,11621,12747
202004,11215,서울특별시,광진구,60-64세,24409,11657,12752
202005,11215,서울특별시,광진구,60-64세,24464,11684,12780
202006,11215,서울특별시,광진구,60-64세,24688,11796,12892
202001,11215,서울특별시,광진구,65-69세,16225,7678,8547
202002,11215,서울특별시,광진구,65-69세,16376,7746,8630
202003,11215,서울특별시,광진구,65-69세,16636,7862,8774
202004,11215,서울특별시,광진구,65-69세,16763,7917,8846
202005,11215,서울특별시,광진구,65-69세,16835,7933,8902
202006,11215,서울특별시,광진구,65-69세,16872,7951,8921
202001,11215,서울특별시,광진구,70-74세,12527,5789,6738
202002,11215,서울특별시,광진구,70-74세,12553,5794,6759
202003,11215,서울특별시,광진구,70-74세,12610,5821,6789
202004,11215,서울특별시,광진구,70-74세,12631,5833,6798
202005,11215,서울특별시,광진구,70-74세,12594,5809,6785
202006,11215,서울특별시,광진구,70-74세,12596,5797,6799
202001,11215,서울특별시,광진구,75-79세,9493,4364,5129
202002,11215,서울특별시,광진구,75-79세,9509,4372,5137
202003,11215,서울특별시,광진구,75-79세,9553,4379,5174
202004,11215,서울특별시,광진구,75-79세,9564,4378,5186
202005,11215,서울특별시,광진구,75-79세,9614,4404,5210
202006,11215,서울특별시,광진구,75-79세,9685,4432,5253
202001,11215,서울특별시,광진구,80-84세,5811,2373,3438
202002,11215,서울특별시,광진구,80-84세,5854,2402,3452
202003,11215,서울특별시,광진구,80-84세,5893,2418,3475
202004,11215,서울특별시,광진구,80-84세,5915,2433,3482
202005,11215,서울특별시,광진구,80-84세,5943,2459,3484
202006,11215,서울특별시,광진구,80-84세,5976,2490,3486
202001,11215,서울특별시,광진구,85-89세,2527,837,1690
202002,11215,서울특별시,광진구,85-89세,2554,849,1705
202003,11215,서울특별시,광진구,85-89세,2589,861,1728
202004,11215,서울특별시,광진구,85-89세,2594,863,1731
202005,11215,서울특별시,광진구,85-89세,2610,871,1739
202006,11215,서울특별시,광진구,85-89세,2601,868,1733
202001,11215,서울특별시,광진구,90-94세,948,268,680
202002,11215,서울특별시,광진구,90-94세,951,265,686
202003,11215,서울특별시,광진구,90-94세,954,264,690
202004,11215,서울특별시,광진구,90-94세,956,265,691
202005,11215,서울특별시,광진구,90-94세,964,269,695
202006,11215,서울특별시,광진구,90-94세,976,275,701
202001,11215,서울특별시,광진구,95-99세,269,65,204
202002,11215,서울특별시,광진구,95-99세,271,66,205
202003,11215,서울특별시,광진구,95-99세,281,71,210
202004,11215,서울특별시,광진구,95-99세,290,73,217
202005,11215,서울특별시,광진구,95-99세,284,71,213
202006,11215,서울특별시,광진구,95-99세,279,70,209
202001,11215,서울특별시,광진구,100+,203,43,160
202002,11215,서울특별시,광진구,100+,203,44,159
202003,11215,서울특별시,광진구,100+,205,45,160
202004,11215,서울특별시,광진구,100+,206,47,159
202005,11215,서울특별시,광진구,100+,208,49,159
202006,11215,서울특별시,광진구,100+,211,51,160
202001,11230,서울특별시,동대문구,0-4세,10385,5338,5047
202002,11230,서울특별시,동대문구,0-4세,10309,5280,5029
202003,11230,서울특별시,동대문구,0-4세,10282,5265,5017
202004,11230,서울특별시,동대문구,0-4세,10175,5219,4956
202005,11230,서울특별시,동대문구,0-4세,10120,5186,4934
202006,11230,서울특별시,동대문구,0-4세,10016,5134,4882
202001,11230,서울특별시,동대문구,5-9세,11613,5936,5677
202002,11230,서울특별시,동대문구,5-9세,11515,5893,5622
202003,11230,서울특별시,동대문구,5-9세,11468,5861,5607
202004,11230,서울특별시,동대문구,5-9세,11457,5828,5629
202005,11230,서울특별시,동대문구,5-9세,11464,5845,5619
202006,11230,서울특별시,동대문구,5-9세,11485,5859,5626
202001,11230,서울특별시,동대문구,10-14세,11156,5712,5444
202002,11230,서울특별시,동대문구,10-14세,11131,5691,5440
202003,11230,서울특별시,동대문구,10-14세,11104,5679,5425
202004,11230,서울특별시,동대문구,10-14세,11072,5682,5390
202005,11230,서울특별시,동대문구,10-14세,11073,5661,5412
202006,11230,서울특별시,동대문구,10-14세,11072,5666,5406
202001,11230,서울특별시,동대문구,15-19세,13931,7032,6899
202002,11230,서울특별시,동대문구,15-19세,13966,6990,6976
202003,11230,서울특별시,동대문구,15-19세,13985,7003,6982
202004,11230,서울특별시,동대문구,15-19세,13872,6936,6936
202005,11230,서울특별시,동대문구,15-19세,13729,6879,6850
202006,11230,서울특별시,동대문구,15-19세,13594,6805,6789
202001,11230,서울특별시,동대문구,20-24세,25504,12071,13433
202002,11230,서울특별시,동대문구,20-24세,25747,12186,13561
202003,11230,서울특별시,동대문구,20-24세,25929,12289,13640
202004,11230,서울특별시,동대문구,20-24세,26075,12310,13765
202005,11230,서울특별시,동대문구,20-24세,26135,12247,13888
202006,11230,서울특별시,동대문구,20-24세,26153,12225,13928
202001,11230,서울특별시,동대문구,25-29세,29577,15637,13940
202002,11230,서울특별시,동대문구,25-29세,29397,15550,13847
202003,11230,서울특별시,동대문구,25-29세,29559,15644,13915
202004,11230,서울특별시,동대문구,25-29세,29605,15631,13974
202005,11230,서울특별시,동대문구,25-29세,29806,15706,14100
202006,11230,서울특별시,동대문구,25-29세,29973,15784,14189
202001,11230,서울특별시,동대문구,30-34세,24310,12677,11633
202002,11230,서울특별시,동대문구,30-34세,24361,12686,11675
202003,11230,서울특별시,동대문구,30-34세,24453,12710,11743
202004,11230,서울특별시,동대문구,30-34세,24428,12705,11723
202005,11230,서울특별시,동대문구,30-34세,24420,12733,11687
202006,11230,서울특별시,동대문구,30-34세,24475,12765,11710
202001,11230,서울특별시,동대문구,35-39세,27018,13961,13057
202002,11230,서울특별시,동대문구,35-39세,26894,13880,13014
202003,11230,서울특별시,동대문구,35-39세,26783,13833,12950
202004,11230,서울특별시,동대문구,35-39세,26672,13777,12895
202005,11230,서울특별시,동대문구,35-39세,26624,13731,12893
202006,11230,서울특별시,동대문구,35-39세,26514,13661,12853
202001,11230,서울특별시,동대문구,40-44세,24609,12735,11874
202002,11230,서울특별시,동대문구,40-44세,24561,12723,11838
202003,11230,서울특별시,동대문구,40-44세,24420,12652,11768
202004,11230,서울특별시,동대문구,40-44세,24363,12610,11753
202005,11230,서울특별시,동대문구,40-44세,24330,12601,11729
202006,11230,서울특별시,동대문구,40-44세,24296,12587,11709
202001,11230,서울특별시,동대문구,45-49세,27818,14286,13532
202002,11230,서울특별시,동대문구,45-49세,27784,14231,13553
202003,11230,서울특별시,동대문구,45-49세,27666,14172,13494
202004,11230,서울특별시,동대문구,45-49세,27530,14098,13432
202005,11230,서울특별시,동대문구,45-49세,27421,14071,13350
202006,11230,서울특별시,동대문구,45-49세,27297,14036,13261
202001,11230,서울특별시,동대문구,50-54세,27183,13783,13400
202002,11230,서울특별시,동대문구,50-54세,27175,13785,13390
202003,11230,서울특별시,동대문구,50-54세,27122,13763,13359
202004,11230,서울특별시,동대문구,50-54세,27089,13757,13332
202005,11230,서울특별시,동대문구,50-54세,27102,13759,13343
202006,11230,서울특별시,동대문구,50-54세,27130,13742,13388
202001,11230,서울특별시,동대문구,55-59세,27366,13606,13760
202002,11230,서울특별시,동대문구,55-59세,27314,13602,13712
202003,11230,서울특별시,동대문구,55-59세,27210,13578,13632
202004,11230,서울특별시,동대문구,55-59세,27102,13527,13575
202005,11230,서울특별시,동대문구,55-59세,27022,13476,13546
202006,11230,서울특별시,동대문구,55-59세,26801,13374,13427
202001,11230,서울특별시,동대문구,60-64세,26131,12716,13415
202002,11230,서울특별시,동대문구,60-64세,26178,12731,13447
202003,11230,서울특별시,동대문구,60-64세,26018,12672,13346
202004,11230,서울특별시,동대문구,60-64세,25993,12670,13323
202005,11230,서울특별시,동대문구,60-64세,26015,12714,13301
202006,11230,서울특별시,동대문구,60-64세,26171,12789,13382
202001,11230,서울특별시,동대문구,65-69세,18819,8995,9824
202002,11230,서울특별시,동대문구,65-69세,18966,9076,9890
202003,11230,서울특별시,동대문구,65-69세,19230,9185,10045
202004,11230,서울특별시,동대문구,65-69세,19347,9248,10099
202005,11230,서울특별시,동대문구,65-69세,19428,9294,10134
202006,11230,서울특별시,동대문구,65-69세,19461,9289,10172
202001,11230,서울특별시,동대문구,70-74세,15404,7040,8364
202002,11230,서울특별시,동대문구,70-74세,15415,7039,8376
202003,11230,서울특별시,동대문구,70-74세,15431,7039,8392
202004,11230,서울특별시,동대문구,70-74세,15394,7008,8386
202005,11230,서울특별시,동대문구,70-74세,15373,6994,8379
202006,11230,서울특별시,동대문구,70-74세,15339,6988,8351
202001,11230,서울특별시,동대문구,75-79세,12602,5603,6999
202002,11230,서울특별시,동대문구,75-79세,12609,5616,6993
202003,11230,서울특별시,동대문구,75-79세,12662,5650,7012
202004,11230,서울특별시,동대문구,75-79세,12678,5665,7013
202005,11230,서울특별시,동대문구,75-79세,12750,5695,7055
202006,11230,서울특별시,동대문구,75-79세,12774,5713,7061
202001,11230,서울특별시,동대문구,80-84세,7480,3145,4335
202002,11230,서울특별시,동대문구,80-84세,7507,3157,4350
202003,11230,서울특별시,동대문구,80-84세,7556,3166,4390
202004,11230,서울특별시,동대문구,80-84세,7628,3200,4428
202005,11230,서울특별시,동대문구,80-84세,7651,3210,4441
202006,11230,서울특별시,동대문구,80-84세,7681,3218,4463
202001,11230,서울특별시,동대문구,85-89세,3352,1149,2203
202002,11230,서울특별시,동대문구,85-89세,3409,1176,2233
202003,11230,서울특별시,동대문구,85-89세,3429,1193,2236
202004,11230,서울특별시,동대문구,85-89세,3452,1203,2249
202005,11230,서울특별시,동대문구,85-89세,3485,1215,2270
202006,11230,서울특별시,동대문구,85-89세,3472,1207,2265
202001,11230,서울특별시,동대문구,90-94세,1153,333,820
202002,11230,서울특별시,동대문구,90-94세,1163,333,830
202003,11230,서울특별시,동대문구,90-94세,1181,332,849
202004,11230,서울특별시,동대문구,90-94세,1193,335,858
202005,11230,서울특별시,동대문구,90-94세,1198,334,864
202006,11230,서울특별시,동대문구,90-94세,1212,333,879
202001,11230,서울특별시,동대문구,95-99세,384,125,259
202002,11230,서울특별시,동대문구,95-99세,384,126,258
202003,11230,서울특별시,동대문구,95-99세,378,124,254
202004,11230,서울특별시,동대문구,95-99세,372,123,249
202005,11230,서울특별시,동대문구,95-99세,371,125,246
202006,11230,서울특별시,동대문구,95-99세,375,125,250
202001,11230,서울특별시,동대문구,100+,285,84,201
202002,11230,서울특별시,동대문구,100+,287,84,203
202003,11230,서울특별시,동대문구,100+,290,86,204
202004,11230,서울특별시,동대문구,100+,296,89,207
202005,11230,서울특별시,동대문구,100+,298,89,209
202006,11230,서울특별시,동대문구,100+,302,92,210
202001,11260,서울특별시,중랑구,0-4세,11612,5999,5613
202002,11260,서울특별시,중랑구,0-4세,11466,5915,5551
202003,11260,서울특별시,중랑구,0-4세,11285,5816,5469
202004,11260,서울특별시,중랑구,0-4세,11114,5716,5398
202005,11260,서울특별시,중랑구,0-4세,11060,5714,5346
202006,11260,서울특별시,중랑구,0-4세,10943,5641,5302
202001,11260,서울특별시,중랑구,5-9세,12906,6632,6274
202002,11260,서울특별시,중랑구,5-9세,12805,6583,6222
202003,11260,서울특별시,중랑구,5-9세,12760,6586,6174
202004,11260,서울특별시,중랑구,5-9세,12759,6593,6166
202005,11260,서울특별시,중랑구,5-9세,12735,6575,6160
202006,11260,서울특별시,중랑구,5-9세,12692,6559,6133
202001,11260,서울특별시,중랑구,10-14세,12538,6425,6113
202002,11260,서울특별시,중랑구,10-14세,12471,6403,6068
202003,11260,서울특별시,중랑구,10-14세,12427,6378,6049
202004,11260,서울특별시,중랑구,10-14세,12448,6377,6071
202005,11260,서울특별시,중랑구,10-14세,12460,6378,6082
202006,11260,서울특별시,중랑구,10-14세,12428,6351,6077
202001,11260,서울특별시,중랑구,15-19세,15830,8081,7749
202002,11260,서울특별시,중랑구,15-19세,15673,7984,7689
202003,11260,서울특별시,중랑구,15-19세,15521,7893,7628
202004,11260,서울특별시,중랑구,15-19세,15367,7816,7551
202005,11260,서울특별시,중랑구,15-19세,15207,7757,7450
202006,11260,서울특별시,중랑구,15-19세,15097,7687,7410
202001,11260,서울특별시,중랑구,20-24세,24511,12364,12147
202002,11260,서울특별시,중랑구,20-24세,24461,12309,12152
202003,11260,서울특별시,중랑구,20-24세,24402,12249,12153
202004,11260,서울특별시,중랑구,20-24세,24322,12212,12110
202005,11260,서울특별시,중랑구,20-24세,24297,12184,12113
202006,11260,서울특별시,중랑구,20-24세,24168,12100,12068
202001,11260,서울특별시,중랑구,25-29세,31698,15758,15940
202002,11260,서울특별시,중랑구,25-29세,31632,15729,15903
202003,11260,서울특별시,중랑구,25-29세,31711,15760,15951
202004,11260,서울특별시,중랑구,25-29세,31696,15763,15933
202005,11260,서울특별시,중랑구,25-29세,31793,15805,15988
202006,11260,서울특별시,중랑구,25-29세,31863,15831,16032
202001,11260,서울특별시,중랑구,30-34세,28523,14549,13974
202002,11260,서울특별시,중랑구,30-34세,28532,14553,13979
202003,11260,서울특별시,중랑구,30-34세,28464,14535,13929
202004,11260,서울특별시,중랑구,30-34세,28385,14478,13907
202005,11260,서울특별시,중랑구,30-34세,28481,14529,13952
202006,11260,서울특별시,중랑구,30-34세,28465,14525,13940
202001,11260,서울특별시,중랑구,35-39세,30774,16146,14628
202002,11260,서울특별시,중랑구,35-39세,30589,16051,14538
202003,11260,서울특별시,중랑구,35-39세,30351,15905,14446
202004,11260,서울특별시,중랑구,35-39세,30176,15827,14349
202005,11260,서울특별시,중랑구,35-39세,30020,15740,14280
202006,11260,서울특별시,중랑구,35-39세,29889,15640,14249
202001,11260,서울특별시,중랑구,40-44세,27252,14234,13018
202002,11260,서울특별시,중랑구,40-44세,27250,14248,13002
202003,11260,서울특별시,중랑구,40-44세,27165,14214,12951
202004,11260,서울특별시,중랑구,40-44세,27177,14244,12933
202005,11260,서울특별시,중랑구,40-44세,27136,14206,12930
202006,11260,서울특별시,중랑구,40-44세,27158,14251,12907
202001,11260,서울특별시,중랑구,45-49세,32034,16282,15752
202002,11260,서울특별시,중랑구,45-49세,31954,16228,15726
202003,11260,서울특별시,중랑구,45-49세,31701,16118,15583
202004,11260,서울특별시,중랑구,45-49세,31504,16008,15496
202005,11260,서울특별시,중랑구,45-49세,31351,15928,15423
202006,11260,서울특별시,중랑구,45-49세,31161,15832,15329
202001,11260,서울특별시,중랑구,50-54세,34494,17021,17473
202002,11260,서울특별시,중랑구,50-54세,34458,17025,17433
202003,11260,서울특별시,중랑구,50-54세,34341,16990,17351
202004,11260,서울특별시,중랑구,50-54세,34292,16962,17330
202005,11260,서울특별시,중랑구,50-54세,34245,16922,17323
202006,11260,서울특별시,중랑구,50-54세,34230,16898,17332
202001,11260,서울특별시,중랑구,55-59세,36248,17964,18284
202002,11260,서울특별시,중랑구,55-59세,36168,17888,18280
202003,11260,서울특별시,중랑구,55-59세,36066,17801,18265
202004,11260,서울특별시,중랑구,55-59세,36040,17797,18243
202005,11260,서울특별시,중랑구,55-59세,36049,17817,18232
202006,11260,서울특별시,중랑구,55-59세,35736,17690,18046
202001,11260,서울특별시,중랑구,60-64세,32781,16025,16756
202002,11260,서울특별시,중랑구,60-64세,32855,16082,16773
202003,11260,서울특별시,중랑구,60-64세,32776,16035,16741
202004,11260,서울특별시,중랑구,60-64세,32853,16057,16796
202005,11260,서울특별시,중랑구,60-64세,32866,16020,16846
202006,11260,서울특별시,중랑구,60-64세,33059,16122,16937
202001,11260,서울특별시,중랑구,65-69세,22477,10839,11638
202002,11260,서울특별시,중랑구,65-69세,22699,10906,11793
202003,11260,서울특별시,중랑구,65-69세,23097,11093,12004
202004,11260,서울특별시,중랑구,65-69세,23210,11154,12056
202005,11260,서울특별시,중랑구,65-69세,23363,11272,12091
202006,11260,서울특별시,중랑구,65-69세,23462,11307,12155
202001,11260,서울특별시,중랑구,70-74세,17347,8004,9343
202002,11260,서울특별시,중랑구,70-74세,17401,8041,9360
202003,11260,서울특별시,중랑구,70-74세,17519,8111,9408
202004,11260,서울특별시,중랑구,70-74세,17564,8127,9437
202005,11260,서울특별시,중랑구,70-74세,17594,8127,9467
202006,11260,서울특별시,중랑구,70-74세,17620,8143,9477
202001,11260,서울특별시,중랑구,75-79세,13091,5862,7229
202002,11260,서울특별시,중랑구,75-79세,13106,5873,7233
202003,11260,서울특별시,중랑구,75-79세,13120,5880,7240
202004,11260,서울특별시,중랑구,75-79세,13184,5920,7264
202005,11260,서울특별시,중랑구,75-79세,13277,5957,7320
202006,11260,서울특별시,중랑구,75-79세,13347,5986,7361
202001,11260,서울특별시,중랑구,80-84세,7669,3198,4471
202002,11260,서울특별시,중랑구,80-84세,7721,3212,4509
202003,11260,서울특별시,중랑구,80-84세,7785,3244,4541
202004,11260,서울특별시,중랑구,80-84세,7824,3250,4574
202005,11260,서울특별시,중랑구,80-84세,7849,3260,4589
202006,11260,서울특별시,중랑구,80-84세,7878,3279,4599
202001,11260,서울특별시,중랑구,85-89세,3261,1025,2236
202002,11260,서울특별시,중랑구,85-89세,3335,1058,2277
202003,11260,서울특별시,중랑구,85-89세,3393,1074,2319
202004,11260,서울특별시,중랑구,85-89세,3411,1081,2330
202005,11260,서울특별시,중랑구,85-89세,3440,1094,2346
202006,11260,서울특별시,중랑구,85-89세,3450,1101,2349
202001,11260,서울특별시,중랑구,90-94세,1193,271,922
202002,11260,서울특별시,중랑구,90-94세,1211,271,940
202003,11260,서울특별시,중랑구,90-94세,1206,268,938
202004,11260,서울특별시,중랑구,90-94세,1218,274,944
202005,11260,서울특별시,중랑구,90-94세,1232,279,953
202006,11260,서울특별시,중랑구,90-94세,1236,279,957
202001,11260,서울특별시,중랑구,95-99세,328,82,246
202002,11260,서울특별시,중랑구,95-99세,334,81,253
202003,11260,서울특별시,중랑구,95-99세,335,82,253
202004,11260,서울특별시,중랑구,95-99세,332,83,249
202005,11260,서울특별시,중랑구,95-99세,330,84,246
202006,11260,서울특별시,중랑구,95-99세,333,82,251
202001,11260,서울특별시,중랑구,100+,188,42,146
202002,11260,서울특별시,중랑구,100+,193,43,150
202003,11260,서울특별시,중랑구,100+,194,44,150
202004,11260,서울특별시,중랑구,100+,196,45,151
202005,11260,서울특별시,중랑구,100+,197,45,152
202006,11260,서울특별시,중랑구,100+,199,45,154
202001,11290,서울특별시,성북구,0-4세,13515,6932,6583
202002,11290,서울특별시,성북구,0-4세,13455,6908,6547
202003,11290,서울특별시,성북구,0-4세,13379,6867,6512
202004,11290,서울특별시,성북구,0-4세,13242,6803,6439
202005,11290,서울특별시,성북구,0-4세,13141,6737,6404
202006,11290,서울특별시,성북구,0-4세,13036,6690,6346
202001,11290,서울특별시,성북구,5-9세,17243,8798,8445
202002,11290,서울특별시,성북구,5-9세,17162,8737,8425
202003,11290,서울특별시,성북구,5-9세,17117,8715,8402
202004,11290,서울특별시,성북구,5-9세,17100,8699,8401
202005,11290,서울특별시,성북구,5-9세,17048,8681,8367
202006,11290,서울특별시,성북구,5-9세,17021,8659,8362
202001,11290,서울특별시,성북구,10-14세,17546,9041,8505
202002,11290,서울특별시,성북구,10-14세,17403,8969,8434
202003,11290,서울특별시,성북구,10-14세,17380,8946,8434
202004,11290,서울특별시,성북구,10-14세,17363,8931,8432
202005,11290,서울특별시,성북구,10-14세,17336,8930,8406
202006,11290,서울특별시,성북구,10-14세,17342,8938,8404
202001,11290,서울특별시,성북구,15-19세,21402,10826,10576
202002,11290,서울특별시,성북구,15-19세,21515,10826,10689
202003,11290,서울특별시,성북구,15-19세,21516,10806,10710
202004,11290,서울특별시,성북구,15-19세,21347,10738,10609
202005,11290,서울특별시,성북구,15-19세,21243,10662,10581
202006,11290,서울특별시,성북구,15-19세,21097,10595,10502
202001,11290,서울특별시,성북구,20-24세,32112,14925,17187
202002,11290,서울특별시,성북구,20-24세,32428,15021,17407
202003,11290,서울특별시,성북구,20-24세,32555,15057,17498
202004,11290,서울특별시,성북구,20-24세,32604,15051,17553
202005,11290,서울특별시,성북구,20-24세,32724,15045,17679
202006,11290,서울특별시,성북구,20-24세,32749,15008,17741
202001,11290,서울특별시,성북구,25-29세,34210,17410,16800
202002,11290,서울특별시,성북구,25-29세,33979,17313,16666
202003,11290,서울특별시,성북구,25-29세,34284,17438,16846
202004,11290,서울특별시,성북구,25-29세,34297,17454,16843
202005,11290,서울특별시,성북구,25-29세,34366,17515,16851
202006,11290,서울특별시,성북구,25-29세,34393,17500,16893
202001,11290,서울특별시,성북구,30-34세,28542,14206,14336
202002,11290,서울특별시,성북구,30-34세,28565,14195,14370
202003,11290,서울특별시,성북구,30-34세,28492,14175,14317
202004,11290,서울특별시,성북구,30-34세,28507,14222,14285
202005,11290,서울특별시,성북구,30-34세,28604,14260,14344
202006,11290,서울특별시,성북구,30-34세,28641,14301,14340
202001,11290,서울특별시,성북구,35-39세,33252,16529,16723
202002,11290,서울특별시,성북구,35-39세,33112,16499,16613
202003,11290,서울특별시,성북구,35-39세,32868,16345,16523
202004,11290,서울특별시,성북구,35-39세,32856,16341,16515
202005,11290,서울특별시,성북구,35-39세,32744,16289,16455
202006,11290,서울특별시,성북구,35-39세,32593,16231,16362
202001,11290,서울특별시,성북구,40-44세,32524,16082,16442
202002,11290,서울특별시,성북구,40-44세,32508,16042,16466
202003,11290,서울특별시,성북구,40-44세,32378,15975,16403
202004,11290,서울특별시,성북구,40-44세,32210,15871,16339
202005,11290,서울특별시,성북구,40-44세,32167,15817,16350
202006,11290,서울특별시,성북구,40-44세,32142,15776,16366
202001,11290,서울특별시,성북구,45-49세,39937,19706,20231
202002,11290,서울특별시,성북구,45-49세,39762,19610,20152
202003,11290,서울특별시,성북구,45-49세,39594,19504,20090
202004,11290,서울특별시,성북구,45-49세,39426,19423,20003
202005,11290,서울특별시,성북구,45-49세,39273,19351,19922
202006,11290,서울특별시,성북구,45-49세,39228,19370,19858
202001,11290,서울특별시,성북구,50-54세,36041,18013,18028
202002,11290,서울특별시,성북구,50-54세,36137,18039,18098
202003,11290,서울특별시,성북구,50-54세,36148,18061,18087
202004,11290,서울특별시,성북구,50-54세,36249,18084,18165
202005,11290,서울특별시,성북구,50-54세,36371,18135,18236
202006,11290,서울특별시,성북구,50-54세,36356,18124,18232
202001,11290,서울특별시,성북구,55-59세,33885,16399,17486
202002,11290,서울특별시,성북구,55-59세,33842,16422,17420
202003,11290,서울특별시,성북구,55-59세,33789,16371,17418
202004,11290,서울특별시,성북구,55-59세,33694,16339,17355
202005,11290,서울특별시,성북구,55-59세,33587,16302,17285
202006,11290,서울특별시,성북구,55-59세,33367,16193,17174
202001,11290,서울특별시,성북구,60-64세,31146,14774,16372
202002,11290,서울특별시,성북구,60-64세,31176,14776,16400
202003,11290,서울특별시,성북구,60-64세,30997,14723,16274
202004,11290,서울특별시,성북구,60-64세,31031,14734,16297
202005,11290,서울특별시,성북구,60-64세,31034,14717,16317
202006,11290,서울특별시,성북구,60-64세,31196,14815,16381
202001,11290,서울특별시,성북구,65-69세,22022,10301,11721
202002,11290,서울특별시,성북구,65-69세,22198,10371,11827
202003,11290,서울특별시,성북구,65-69세,22551,10492,12059
202004,11290,서울특별시,성북구,65-69세,22676,10551,12125
202005,11290,서울특별시,성북구,65-69세,22736,10570,12166
202006,11290,서울특별시,성북구,65-69세,22748,10570,12178
202001,11290,서울특별시,성북구,70-74세,18243,7944,10299
202002,11290,서울특별시,성북구,70-74세,18272,7945,10327
202003,11290,서울특별시,성북구,70-74세,18352,8030,10322
202004,11290,서울특별시,성북구,70-74세,18357,8006,10351
202005,11290,서울특별시,성북구,70-74세,18407,8028,10379
202006,11290,서울특별시,성북구,70-74세,18461,8070,10391
202001,11290,서울특별시,성북구,75-79세,15108,6569,8539
202002,11290,서울특별시,성북구,75-79세,15110,6581,8529
202003,11290,서울특별시,성북구,75-79세,15113,6560,8553
202004,11290,서울특별시,성북구,75-79세,15137,6603,8534
202005,11290,서울특별시,성북구,75-79세,15208,6652,8556
202006,11290,서울특별시,성북구,75-79세,15252,6672,8580
202001,11290,서울특별시,성북구,80-84세,9411,3817,5594
202002,11290,서울특별시,성북구,80-84세,9450,3836,5614
202003,11290,서울특별시,성북구,80-84세,9507,3853,5654
202004,11290,서울특별시,성북구,80-84세,9534,3867,5667
202005,11290,서울특별시,성북구,80-84세,9552,3869,5683
202006,11290,서울특별시,성북구,80-84세,9569,3861,5708
202001,11290,서울특별시,성북구,85-89세,4047,1382,2665
202002,11290,서울특별시,성북구,85-89세,4106,1391,2715
202003,11290,서울특별시,성북구,85-89세,4147,1406,2741
202004,11290,서울특별시,성북구,85-89세,4208,1421,2787
202005,11290,서울특별시,성북구,85-89세,4257,1450,2807
202006,11290,서울특별시,성북구,85-89세,4263,1459,2804
202001,11290,서울특별시,성북구,90-94세,1517,395,1122
202002,11290,서울특별시,성북구,90-94세,1532,400,1132
202003,11290,서울특별시,성북구,90-94세,1554,409,1145
202004,11290,서울특별시,성북구,90-94세,1560,413,1147
202005,11290,서울특별시,성북구,90-94세,1575,416,1159
202006,11290,서울특별시,성북구,90-94세,1587,413,1174
202001,11290,서울특별시,성북구,95-99세,404,103,301
202002,11290,서울특별시,성북구,95-99세,405,103,302
202003,11290,서울특별시,성북구,95-99세,405,101,304
202004,11290,서울특별시,성북구,95-99세,401,100,301
202005,11290,서울특별시,성북구,95-99세,398,95,303
202006,11290,서울특별시,성북구,95-99세,396,93,303
202001,11290,서울특별시,성북구,100+,364,95,269
202002,11290,서울특별시,성북구,100+,366,94,272
202003,11290,서울특별시,성북구,100+,368,92,276
202004,11290,서울특별시,성북구,100+,375,92,283
202005,11290,서울특별시,성북구,100+,377,93,284
202006,11290,서울특별시,성북구,100+,375,93,282
202001,11305,서울특별시,강북구,0-4세,7591,3879,3712
202002,11305,서울특별시,강북구,0-4세,7481,3815,3666
202003,11305,서울특별시,강북구,0-4세,7401,3813,3588
202004,11305,서울특별시,강북구,0-4세,7282,3747,3535
202005,11305,서울특별시,강북구,0-4세,7173,3695,3478
202006,11305,서울특별시,강북구,0-4세,7109,3673,3436
202001,11305,서울특별시,강북구,5-9세,9734,5054,4680
202002,11305,서울특별시,강북구,5-9세,9686,5055,4631
202003,11305,서울특별시,강북구,5-9세,9636,5007,4629
202004,11305,서울특별시,강북구,5-9세,9636,5016,4620
202005,11305,서울특별시,강북구,5-9세,9632,4998,4634
202006,11305,서울특별시,강북구,5-9세,9579,4960,4619
202001,11305,서울특별시,강북구,10-14세,10248,5255,4993
202002,11305,서울특별시,강북구,10-14세,10222,5260,4962
202003,11305,서울특별시,강북구,10-14세,10209,5253,4956
202004,11305,서울특별시,강북구,10-14세,10154,5211,4943
202005,11305,서울특별시,강북구,10-14세,10152,5224,4928
202006,11305,서울특별시,강북구,10-14세,10127,5213,4914
202001,11305,서울특별시,강북구,15-19세,13227,6827,6400
202002,11305,서울특별시,강북구,15-19세,13091,6746,6345
202003,11305,서울특별시,강북구,15-19세,12973,6681,6292
202004,11305,서울특별시,강북구,15-19세,12880,6631,6249
202005,11305,서울특별시,강북구,15-19세,12764,6569,6195
202006,11305,서울특별시,강북구,15-19세,12645,6510,6135
202001,11305,서울특별시,강북구,20-24세,20344,9709,10635
202002,11305,서울특별시,강북구,20-24세,20341,9690,10651
202003,11305,서울특별시,강북구,20-24세,20352,9702,10650
202004,11305,서울특별시,강북구,20-24세,20368,9700,10668
202005,11305,서울특별시,강북구,20-24세,20320,9638,10682
202006,11305,서울특별시,강북구,20-24세,20268,9587,10681
202001,11305,서울특별시,강북구,25-29세,23038,11624,11414
202002,11305,서울특별시,강북구,25-29세,22979,11608,11371
202003,11305,서울특별시,강북구,25-29세,23074,11653,11421
202004,11305,서울특별시,강북구,25-29세,23059,11632,11427
202005,11305,서울특별시,강북구,25-29세,23071,11650,11421
202006,11305,서울특별시,강북구,25-29세,23053,11635,11418
202001,11305,서울특별시,강북구,30-34세,18896,9871,9025
202002,11305,서울특별시,강북구,30-34세,18818,9834,8984
202003,11305,서울특별시,강북구,30-34세,18783,9834,8949
202004,11305,서울특별시,강북구,30-34세,18817,9873,8944
202005,11305,서울특별시,강북구,30-34세,18810,9863,8947
202006,11305,서울특별시,강북구,30-34세,18803,9861,8942
202001,11305,서울특별시,강북구,35-39세,21838,11515,10323
202002,11305,서울특별시,강북구,35-39세,21648,11422,10226
202003,11305,서울특별시,강북구,35-39세,21448,11316,10132
202004,11305,서울특별시,강북구,35-39세,21276,11237,10039
202005,11305,서울특별시,강북구,35-39세,21147,11147,10000
202006,11305,서울특별시,강북구,35-39세,21016,11103,9913
202001,11305,서울특별시,강북구,40-44세,21675,11171,10504
202002,11305,서울특별시,강북구,40-44세,21719,11217,10502
202003,11305,서울특별시,강북구,40-44세,21657,11184,10473
202004,11305,서울특별시,강북구,40-44세,21623,11174,10449
202005,11305,서울특별시,강북구,40-44세,21562,11160,10402
202006,11305,서울특별시,강북구,40-44세,21519,11108,10411
202001,11305,서울특별시,강북구,45-49세,27210,13810,13400
202002,11305,서울특별시,강북구,45-49세,27108,13752,13356
202003,11305,서울특별시,강북구,45-49세,26962,13691,13271
202004,11305,서울특별시,강북구,45-49세,26851,13643,13208
202005,11305,서울특별시,강북구,45-49세,26676,13537,13139
202006,11305,서울특별시,강북구,45-49세,26553,13484,13069
202001,11305,서울특별시,강북구,50-54세,26528,12997,13531
202002,11305,서울특별시,강북구,50-54세,26572,13014,13558
202003,11305,서울특별시,강북구,50-54세,26539,13029,13510
202004,11305,서울특별시,강북구,50-54세,26576,13024,13552
202005,11305,서울특별시,강북구,50-54세,26621,13074,13547
202006,11305,서울특별시,강북구,50-54세,26615,13077,13538
202001,11305,서울특별시,강북구,55-59세,27022,13051,13971
202002,11305,서울특별시,강북구,55-59세,26952,13031,13921
202003,11305,서울특별시,강북구,55-59세,26898,13008,13890
202004,11305,서울특별시,강북구,55-59세,26836,13019,13817
202005,11305,서울특별시,강북구,55-59세,26803,13012,13791
202006,11305,서울특별시,강북구,55-59세,26642,12927,13715
202001,11305,서울특별시,강북구,60-64세,25568,12166,13402
202002,11305,서울특별시,강북구,60-64세,25618,12161,13457
202003,11305,서울특별시,강북구,60-64세,25516,12114,13402
202004,11305,서울특별시,강북구,60-64세,25539,12102,13437
202005,11305,서울특별시,강북구,60-64세,25545,12100,13445
202006,11305,서울특별시,강북구,60-64세,25626,12153,13473
202001,11305,서울특별시,강북구,65-69세,18814,8540,10274
202002,11305,서울특별시,강북구,65-69세,18925,8607,10318
202003,11305,서울특별시,강북구,65-69세,19201,8708,10493
202004,11305,서울특별시,강북구,65-69세,19313,8775,10538
202005,11305,서울특별시,강북구,65-69세,19369,8793,10576
202006,11305,서울특별시,강북구,65-69세,19459,8818,10641
202001,11305,서울특별시,강북구,70-74세,16257,7052,9205
202002,11305,서울특별시,강북구,70-74세,16279,7070,9209
202003,11305,서울특별시,강북구,70-74세,16293,7090,9203
202004,11305,서울특별시,강북구,70-74세,16286,7078,9208
202005,11305,서울특별시,강북구,70-74세,16246,7080,9166
202006,11305,서울특별시,강북구,70-74세,16283,7102,9181
202001,11305,서울특별시,강북구,75-79세,13416,5904,7512
202002,11305,서울특별시,강북구,75-79세,13395,5881,7514
202003,11305,서울특별시,강북구,75-79세,13426,5891,7535
202004,11305,서울특별시,강북구,75-79세,13481,5917,7564
202005,11305,서울특별시,강북구,75-79세,13592,5937,7655
202006,11305,서울특별시,강북구,75-79세,13656,5941,7715
202001,11305,서울특별시,강북구,80-84세,7678,3161,4517
202002,11305,서울특별시,강북구,80-84세,7743,3189,4554
202003,11305,서울특별시,강북구,80-84세,7828,3228,4600
202004,11305,서울특별시,강북구,80-84세,7892,3258,4634
202005,11305,서울특별시,강북구,80-84세,7932,3287,4645
202006,11305,서울특별시,강북구,80-84세,7949,3301,4648
202001,11305,서울특별시,강북구,85-89세,2978,1023,1955
202002,11305,서울특별시,강북구,85-89세,3048,1049,1999
202003,11305,서울특별시,강북구,85-89세,3104,1081,2023
202004,11305,서울특별시,강북구,85-89세,3125,1087,2038
202005,11305,서울특별시,강북구,85-89세,3146,1098,2048
202006,11305,서울특별시,강북구,85-89세,3164,1106,2058
202001,11305,서울특별시,강북구,90-94세,1096,306,790
202002,11305,서울특별시,강북구,90-94세,1106,310,796
202003,11305,서울특별시,강북구,90-94세,1117,314,803
202004,11305,서울특별시,강북구,90-94세,1129,318,811
202005,11305,서울특별시,강북구,90-94세,1137,320,817
202006,11305,서울특별시,강북구,90-94세,1131,319,812
202001,11305,서울특별시,강북구,95-99세,310,84,226
202002,11305,서울특별시,강북구,95-99세,322,87,235
202003,11305,서울특별시,강북구,95-99세,330,90,240
202004,11305,서울특별시,강북구,95-99세,326,92,234
202005,11305,서울특별시,강북구,95-99세,328,90,238
202006,11305,서울특별시,강북구,95-99세,332,90,242
202001,11305,서울특별시,강북구,100+,237,59,178
202002,11305,서울특별시,강북구,100+,236,59,177
202003,11305,서울특별시,강북구,100+,238,60,178
202004,11305,서울특별시,강북구,100+,242,60,182
202005,11305,서울특별시,강북구,100+,244,61,183
202006,11305,서울특별시,강북구,100+,244,60,184
202001,11320,서울특별시,도봉구,0-4세,9008,4680,4328
202002,11320,서울특별시,도봉구,0-4세,8855,4593,4262
202003,11320,서울특별시,도봉구,0-4세,8736,4521,4215
202004,11320,서울특별시,도봉구,0-4세,8629,4468,4161
202005,11320,서울특별시,도봉구,0-4세,8524,4413,4111
202006,11320,서울특별시,도봉구,0-4세,8457,4380,4077
202001,11320,서울특별시,도봉구,5-9세,11484,5890,5594
202002,11320,서울특별시,도봉구,5-9세,11415,5845,5570
202003,11320,서울특별시,도봉구,5-9세,11363,5829,5534
202004,11320,서울특별시,도봉구,5-9세,11330,5814,5516
202005,11320,서울특별시,도봉구,5-9세,11301,5803,5498
202006,11320,서울특별시,도봉구,5-9세,11265,5793,5472
202001,11320,서울특별시,도봉구,10-14세,11879,6119,5760
202002,11320,서울특별시,도봉구,10-14세,11812,6093,5719
202003,11320,서울특별시,도봉구,10-14세,11777,6063,5714
202004,11320,서울특별시,도봉구,10-14세,11751,6051,5700
202005,11320,서울특별시,도봉구,10-14세,11750,6049,5701
202006,11320,서울특별시,도봉구,10-14세,11761,6061,5700
202001,11320,서울특별시,도봉구,15-19세,15532,8002,7530
202002,11320,서울특별시,도봉구,15-19세,15382,7927,7455
202003,11320,서울특별시,도봉구,15-19세,15193,7826,7367
202004,11320,서울특별시,도봉구,15-19세,15017,7747,7270
202005,11320,서울특별시,도봉구,15-19세,14901,7692,7209
202006,11320,서울특별시,도봉구,15-19세,14764,7610,7154
202001,11320,서울특별시,도봉구,20-24세,21452,10943,10509
202002,11320,서울특별시,도봉구,20-24세,21423,10888,10535
202003,11320,서울특별시,도봉구,20-24세,21323,10823,10500
202004,11320,서울특별시,도봉구,20-24세,21299,10804,10495
202005,11320,서울특별시,도봉구,20-24세,21210,10730,10480
202006,11320,서울특별시,도봉구,20-24세,21142,10691,10451
202001,11320,서울특별시,도봉구,25-29세,23457,12023,11434
202002,11320,서울특별시,도봉구,25-29세,23339,11954,11385
202003,11320,서울특별시,도봉구,25-29세,23396,11982,11414
202004,11320,서울특별시,도봉구,25-29세,23382,11987,11395
202005,11320,서울특별시,도봉구,25-29세,23298,11947,11351
202006,11320,서울특별시,도봉구,25-29세,23261,11907,11354
202001,11320,서울특별시,도봉구,30-34세,19814,10137,9677
202002,11320,서울특별시,도봉구,30-34세,19737,10107,9630
202003,11320,서울특별시,도봉구,30-34세,19622,10074,9548
202004,11320,서울특별시,도봉구,30-34세,19579,10057,9522
202005,11320,서울특별시,도봉구,30-34세,19543,10023,9520
202006,11320,서울특별시,도봉구,30-34세,19521,10011,9510
202001,11320,서울특별시,도봉구,35-39세,23298,11910,11388
202002,11320,서울특별시,도봉구,35-39세,23129,11828,11301
202003,11320,서울특별시,도봉구,35-39세,23010,11751,11259
202004,11320,서울특별시,도봉구,35-39세,22867,11680,11187
202005,11320,서울특별시,도봉구,35-39세,22737,11613,11124
202006,11320,서울특별시,도봉구,35-39세,22603,11533,11070
202001,11320,서울특별시,도봉구,40-44세,22433,11244,11189
202002,11320,서울특별시,도봉구,40-44세,22380,11245,11135
202003,11320,서울특별시,도봉구,40-44세,22225,11151,11074
202004,11320,서울특별시,도봉구,40-44세,22120,11096,11024
202005,11320,서울특별시,도봉구,40-44세,22097,11088,11009
202006,11320,서울특별시,도봉구,40-44세,22075,11068,11007
202001,11320,서울특별시,도봉구,45-49세,28488,13971,14517
202002,11320,서울특별시,도봉구,45-49세,28356,13878,14478
202003,11320,서울특별시,도봉구,45-49세,28160,13789,14371
202004,11320,서울특별시,도봉구,45-49세,27964,13702,14262
202005,11320,서울특별시,도봉구,45-49세,27795,13595,14200
202006,11320,서울특별시,도봉구,45-49세,27644,13529,14115
202001,11320,서울특별시,도봉구,50-54세,28757,13659,15098
202002,11320,서울특별시,도봉구,50-54세,28816,13696,15120
202003,11320,서울특별시,도봉구,50-54세,28727,13699,15028
202004,11320,서울특별시,도봉구,50-54세,28807,13735,15072
202005,11320,서울특별시,도봉구,50-54세,28856,13765,15091
202006,11320,서울특별시,도봉구,50-54세,28855,13784,15071
202001,11320,서울특별시,도봉구,55-59세,29681,14150,15531
202002,11320,서울특별시,도봉구,55-59세,29554,14096,15458
202003,11320,서울특별시,도봉구,55-59세,29446,14034,15412
202004,11320,서울특별시,도봉구,55-59세,29357,13951,15406
202005,11320,서울특별시,도봉구,55-59세,29220,13881,15339
202006,11320,서울특별시,도봉구,55-59세,28917,13772,15145
202001,11320,서울특별시,도봉구,60-64세,28404,13532,14872
202002,11320,서울특별시,도봉구,60-64세,28477,13569,14908
202003,11320,서울특별시,도봉구,60-64세,28292,13471,14821
202004,11320,서울특별시,도봉구,60-64세,28334,13514,14820
202005,11320,서울특별시,도봉구,60-64세,28387,13517,14870
202006,11320,서울특별시,도봉구,60-64세,28563,13552,15011
202001,11320,서울특별시,도봉구,65-69세,19213,9355,9858
202002,11320,서울특별시,도봉구,65-69세,19395,9441,9954
202003,11320,서울특별시,도봉구,65-69세,19790,9613,10177
202004,11320,서울특별시,도봉구,65-69세,19942,9673,10269
202005,11320,서울특별시,도봉구,65-69세,20057,9713,10344
202006,11320,서울특별시,도봉구,65-69세,20145,9756,10389
202001,11320,서울특별시,도봉구,70-74세,14940,6952,7988
202002,11320,서울특별시,도봉구,70-74세,15056,6995,8061
202003,11320,서울특별시,도봉구,70-74세,15135,7051,8084
202004,11320,서울특별시,도봉구,70-74세,15174,7045,8129
202005,11320,서울특별시,도봉구,70-74세,15218,7078,8140
202006,11320,서울특별시,도봉구,70-74세,15270,7098,8172
202001,11320,서울특별시,도봉구,75-79세,12226,5523,6703
202002,11320,서울특별시,도봉구,75-79세,12141,5507,6634
202003,11320,서울특별시,도봉구,75-79세,12119,5481,6638
202004,11320,서울특별시,도봉구,75-79세,12174,5526,6648
202005,11320,서울특별시,도봉구,75-79세,12217,5523,6694
202006,11320,서울특별시,도봉구,75-79세,12257,5536,6721
202001,11320,서울특별시,도봉구,80-84세,7525,3019,4506
202002,11320,서울특별시,도봉구,80-84세,7604,3060,4544
202003,11320,서울특별시,도봉구,80-84세,7647,3101,4546
202004,11320,서울특별시,도봉구,80-84세,7662,3102,4560
202005,11320,서울특별시,도봉구,80-84세,7691,3125,4566
202006,11320,서울특별시,도봉구,80-84세,7701,3118,4583
202001,11320,서울특별시,도봉구,85-89세,3410,1119,2291
202002,11320,서울특별시,도봉구,85-89세,3454,1133,2321
202003,11320,서울특별시,도봉구,85-89세,3500,1144,2356
202004,11320,서울특별시,도봉구,85-89세,3533,1145,2388
202005,11320,서울특별시,도봉구,85-89세,3558,1153,2405
202006,11320,서울특별시,도봉구,85-89세,3559,1168,2391
202001,11320,서울특별시,도봉구,90-94세,1273,345,928
202002,11320,서울특별시,도봉구,90-94세,1278,344,934
202003,11320,서울특별시,도봉구,90-94세,1300,350,950
202004,11320,서울특별시,도봉구,90-94세,1304,359,945
202005,11320,서울특별시,도봉구,90-94세,1305,361,944
202006,11320,서울특별시,도봉구,90-94세,1315,362,953
202001,11320,서울특별시,도봉구,95-99세,315,87,228
202002,11320,서울특별시,도봉구,95-99세,314,88,226
202003,11320,서울특별시,도봉구,95-99세,311,84,227
202004,11320,서울특별시,도봉구,95-99세,316,82,234
202005,11320,서울특별시,도봉구,95-99세,314,81,233
202006,11320,서울특별시,도봉구,95-99세,313,80,233
202001,11320,서울특별시,도봉구,100+,164,41,123
202002,11320,서울특별시,도봉구,100+,166,40,126
202003,11320,서울특별시,도봉구,100+,166,42,124
202004,11320,서울특별시,도봉구,100+,166,43,123
202005,11320,서울특별시,도봉구,100+,170,45,125
202006,11320,서울특별시,도봉구,100+,172,46,126
202001,11350,서울특별시,노원구,0-4세,15185,7814,7371
202002,11350,서울특별시,노원구,0-4세,15060,7723,7337
202003,11350,서울특별시,노원구,0-4세,14897,7636,7261
202004,11350,서울특별시,노원구,0-4세,14735,7547,7188
202005,11350,서울특별시,노원구,0-4세,14617,7481,7136
202006,11350,서울특별시,노원구,0-4세,14495,7419,7076
202001,11350,서울특별시,노원구,5-9세,20479,10551,9928
202002,11350,서울특별시,노원구,5-9세,20527,10590,9937
202003,11350,서울특별시,노원구,5-9세,20496,10587,9909
202004,11350,서울특별시,노원구,5-9세,20417,10559,9858
202005,11350,서울특별시,노원구,5-9세,20372,10557,9815
202006,11350,서울특별시,노원구,5-9세,20308,10522,9786
202001,11350,서울특별시,노원구,10-14세,24621,12785,11836
202002,11350,서울특별시,노원구,10-14세,24641,12796,11845
202003,11350,서울특별시,노원구,10-14세,24548,12754,11794
202004,11350,서울특별시,노원구,10-14세,24492,12726,11766
202005,11350,서울특별시,노원구,10-14세,24398,12665,11733
202006,11350,서울특별시,노원구,10-14세,24355,12666,11689
202001,11350,서울특별시,노원구,15-19세,31925,16604,15321
202002,11350,서울특별시,노원구,15-19세,31564,16391,15173
202003,11350,서울특별시,노원구,15-19세,31263,16187,15076
202004,11350,서울특별시,노원구,15-19세,31043,16034,15009
202005,11350,서울특별시,노원구,15-19세,30739,15892,14847
202006,11350,서울특별시,노원구,15-19세,30490,15741,14749
202001,11350,서울특별시,노원구,20-24세,38937,19992,18945
202002,11350,서울특별시,노원구,20-24세,38750,19915,18835
202003,11350,서울특별시,노원구,20-24세,38713,19872,18841
202004,11350,서울특별시,노원구,20-24세,38608,19852,18756
202005,11350,서울특별시,노원구,20-24세,38594,19818,18776
202006,11350,서울특별시,노원구,20-24세,38463,19703,18760
202001,11350,서울특별시,노원구,25-29세,35509,18415,17094
202002,11350,서울특별시,노원구,25-29세,35209,18249,16960
202003,11350,서울특별시,노원구,25-29세,35327,18304,17023
202004,11350,서울특별시,노원구,25-29세,35380,18265,17115
202005,11350,서울특별시,노원구,25-29세,35401,18307,17094
202006,11350,서울특별시,노원구,25-29세,35441,18345,17096
202001,11350,서울특별시,노원구,30-34세,30519,15291,15228
202002,11350,서울특별시,노원구,30-34세,30583,15346,15237
202003,11350,서울특별시,노원구,30-34세,30571,15318,15253
202004,11350,서울특별시,노원구,30-34세,30588,15370,15218
202005,11350,서울특별시,노원구,30-34세,30610,15385,15225
202006,11350,서울특별시,노원구,30-34세,30626,15394,15232
202001,11350,서울특별시,노원구,35-39세,36655,18135,18520
202002,11350,서울특별시,노원구,35-39세,36464,18062,18402
202003,11350,서울특별시,노원구,35-39세,36296,17962,18334
202004,11350,서울특별시,노원구,35-39세,36143,17889,18254
202005,11350,서울특별시,노원구,35-39세,35990,17829,18161
202006,11350,서울특별시,노원구,35-39세,35781,17746,18035
202001,11350,서울특별시,노원구,40-44세,39147,18680,20467
202002,11350,서울특별시,노원구,40-44세,39198,18668,20530
202003,11350,서울특별시,노원구,40-44세,38996,18584,20412
202004,11350,서울특별시,노원구,40-44세,38824,18489,20335
202005,11350,서울특별시,노원구,40-44세,38697,18453,20244
202006,11350,서울특별시,노원구,40-44세,38679,18449,20230
202001,11350,서울특별시,노원구,45-49세,50671,24152,26519
202002,11350,서울특별시,노원구,45-49세,50456,24113,26343
202003,11350,서울특별시,노원구,45-49세,50171,23952,26219
202004,11350,서울특별시,노원구,45-49세,50003,23881,26122
202005,11350,서울특별시,노원구,45-49세,49767,23731,26036
202006,11350,서울특별시,노원구,45-49세,49523,23595,25928
202001,11350,서울특별시,노원구,50-54세,46199,22498,23701
202002,11350,서울특별시,노원구,50-54세,46208,22463,23745
202003,11350,서울특별시,노원구,50-54세,46247,22541,23706
202004,11350,서울특별시,노원구,50-54세,46243,22544,23699
202005,11350,서울특별시,노원구,50-54세,46328,22599,23729
202006,11350,서울특별시,노원구,50-54세,46453,22643,23810
202001,11350,서울특별시,노원구,55-59세,42685,20543,22142
202002,11350,서울특별시,노원구,55-59세,42546,20470,22076
202003,11350,서울특별시,노원구,55-59세,42386,20376,22010
202004,11350,서울특별시,노원구,55-59세,42294,20338,21956
202005,11350,서울특별시,노원구,55-59세,42169,20294,21875
202006,11350,서울특별시,노원구,55-59세,41916,20157,21759
202001,11350,서울특별시,노원구,60-64세,38720,18030,20690
202002,11350,서울특별시,노원구,60-64세,38715,18000,20715
202003,11350,서울특별시,노원구,60-64세,38521,17915,20606
202004,11350,서울특별시,노원구,60-64세,38559,17914,20645
202005,11350,서울특별시,노원구,60-64세,38625,17945,20680
202006,11350,서울특별시,노원구,60-64세,38798,18044,20754
202001,11350,서울특별시,노원구,65-69세,26560,12485,14075
202002,11350,서울특별시,노원구,65-69세,26829,12602,14227
202003,11350,서울특별시,노원구,65-69세,27288,12781,14507
202004,11350,서울특별시,노원구,65-69세,27466,12868,14598
202005,11350,서울특별시,노원구,65-69세,27593,12903,14690
202006,11350,서울특별시,노원구,65-69세,27698,12929,14769
202001,11350,서울특별시,노원구,70-74세,20385,9023,11362
202002,11350,서울특별시,노원구,70-74세,20485,9082,11403
202003,11350,서울특별시,노원구,70-74세,20556,9107,11449
202004,11350,서울특별시,노원구,70-74세,20593,9149,11444
202005,11350,서울특별시,노원구,70-74세,20647,9195,11452
202006,11350,서울특별시,노원구,70-74세,20688,9220,11468
202001,11350,서울특별시,노원구,75-79세,16298,6803,9495
202002,11350,서울특별시,노원구,75-79세,16293,6798,9495
202003,11350,서울특별시,노원구,75-79세,16305,6787,9518
202004,11350,서울특별시,노원구,75-79세,16369,6800,9569
202005,11350,서울특별시,노원구,75-79세,16440,6823,9617
202006,11350,서울특별시,노원구,75-79세,16508,6858,9650
202001,11350,서울특별시,노원구,80-84세,10563,3776,6787
202002,11350,서울특별시,노원구,80-84세,10611,3802,6809
202003,11350,서울특별시,노원구,80-84세,10651,3846,6805
202004,11350,서울특별시,노원구,80-84세,10673,3873,6800
202005,11350,서울특별시,노원구,80-84세,10696,3907,6789
202006,11350,서울특별시,노원구,80-84세,10724,3934,6790
202001,11350,서울특별시,노원구,85-89세,5082,1540,3542
202002,11350,서울특별시,노원구,85-89세,5131,1550,3581
202003,11350,서울특별시,노원구,85-89세,5194,1567,3627
202004,11350,서울특별시,노원구,85-89세,5226,1581,3645
202005,11350,서울특별시,노원구,85-89세,5281,1596,3685
202006,11350,서울특별시,노원구,85-89세,5273,1587,3686
202001,11350,서울특별시,노원구,90-94세,1774,427,1347
202002,11350,서울특별시,노원구,90-94세,1813,444,1369
202003,11350,서울특별시,노원구,90-94세,1851,452,1399
202004,11350,서울특별시,노원구,90-94세,1880,466,1414
202005,11350,서울특별시,노원구,90-94세,1883,468,1415
202006,11350,서울특별시,노원구,90-94세,1902,475,1427
202001,11350,서울특별시,노원구,95-99세,491,124,367
202002,11350,서울특별시,노원구,95-99세,496,121,375
202003,11350,서울특별시,노원구,95-99세,498,119,379
202004,11350,서울특별시,노원구,95-99세,505,119,386
202005,11350,서울특별시,노원구,95-99세,505,116,389
202006,11350,서울특별시,노원구,95-99세,494,115,379
202001,11350,서울특별시,노원구,100+,257,78,179
202002,11350,서울특별시,노원구,100+,261,80,181
202003,11350,서울특별시,노원구,100+,262,79,183
202004,11350,서울특별시,노원구,100+,261,80,181
202005,11350,서울특별시,노원구,100+,265,81,184
202006,11350,서울특별시,노원구,100+,272,82,190
202001,11380,서울특별시,은평구,0-4세,14104,7163,6941
202002,11380,서울특별시,은평구,0-4세,13943,7080,6863
202003,11380,서울특별시,은평구,0-4세,13737,6967,6770
202004,11380,서울특별시,은평구,0-4세,13604,6892,6712
202005,11380,서울특별시,은평구,0-4세,13491,6845,6646
202006,11380,서울특별시,은평구,0-4세,13579,6899,6680
202001,11380,서울특별시,은평구,5-9세,17353,8929,8424
202002,11380,서울특별시,은평구,5-9세,17231,8876,8355
202003,11380,서울특별시,은평구,5-9세,17152,8842,8310
202004,11380,서울특별시,은평구,5-9세,17140,8865,8275
202005,11380,서울특별시,은평구,5-9세,17123,8856,8267
202006,11380,서울특별시,은평구,5-9세,17193,8859,8334
202001,11380,서울특별시,은평구,10-14세,18099,9334,8765
202002,11380,서울특별시,은평구,10-14세,18053,9291,8762
202003,11380,서울특별시,은평구,10-14세,18030,9293,8737
202004,11380,서울특별시,은평구,10-14세,18036,9266,8770
202005,11380,서울특별시,은평구,10-14세,18031,9263,8768
202006,11380,서울특별시,은평구,10-14세,18008,9249,8759
202001,11380,서울특별시,은평구,15-19세,22344,11371,10973
202002,11380,서울특별시,은평구,15-19세,22108,11216,10892
202003,11380,서울특별시,은평구,15-19세,21887,11097,10790
202004,11380,서울특별시,은평구,15-19세,21759,11038,10721
202005,11380,서울특별시,은평구,15-19세,21585,10953,10632
202006,11380,서울특별시,은평구,15-19세,21493,10880,10613
202001,11380,서울특별시,은평구,20-24세,29775,14649,15126
202002,11380,서울특별시,은평구,20-24세,29768,14624,15144
202003,11380,서울특별시,은평구,20-24세,29816,14618,15198
202004,11380,서울특별시,은평구,20-24세,29804,14609,15195
202005,11380,서울특별시,은평구,20-24세,29756,14579,15177
202006,11380,서울특별시,은평구,20-24세,29812,14571,15241
202001,11380,서울특별시,은평구,25-29세,36177,17527,18650
202002,11380,서울특별시,은평구,25-29세,36231,17486,18745
202003,11380,서울특별시,은평구,25-29세,36366,17491,18875
202004,11380,서울특별시,은평구,25-29세,36409,17489,18920
202005,11380,서울특별시,은평구,25-29세,36495,17514,18981
202006,11380,서울특별시,은평구,25-29세,36665,17612,19053
202001,11380,서울특별시,은평구,30-34세,31808,15610,16198
202002,11380,서울특별시,은평구,30-34세,31807,15617,16190
202003,11380,서울특별시,은평구,30-34세,31738,15602,16136
202004,11380,서울특별시,은평구,30-34세,31910,15669,16241
202005,11380,서울특별시,은평구,30-34세,31989,15714,16275
202006,11380,서울특별시,은평구,30-34세,32297,15870,16427
202001,11380,서울특별시,은평구,35-39세,37550,18913,18637
202002,11380,서울특별시,은평구,35-39세,37274,18741,18533
202003,11380,서울특별시,은평구,35-39세,36909,18575,18334
202004,11380,서울특별시,은평구,35-39세,36798,18535,18263
202005,11380,서울특별시,은평구,35-39세,36712,18467,18245
202006,11380,서울특별시,은평구,35-39세,36816,18505,18311
202001,11380,서울특별시,은평구,40-44세,35761,17793,17968
202002,11380,서울특별시,은평구,40-44세,35836,17873,17963
202003,11380,서울특별시,은평구,40-44세,35648,17752,17896
202004,11380,서울특별시,은평구,40-44세,35540,17704,17836
202005,11380,서울특별시,은평구,40-44세,35570,17735,17835
202006,11380,서울특별시,은평구,40-44세,35775,17788,17987
202001,11380,서울특별시,은평구,45-49세,42393,20825,21568
202002,11380,서울특별시,은평구,45-49세,42276,20754,21522
202003,11380,서울특별시,은평구,45-49세,42033,20642,21391
202004,11380,서울특별시,은평구,45-49세,41899,20559,21340
202005,11380,서울특별시,은평구,45-49세,41674,20474,21200
202006,11380,서울특별시,은평구,45-49세,41616,20474,21142
202001,11380,서울특별시,은평구,50-54세,38852,18901,19951
202002,11380,서울특별시,은평구,50-54세,38848,18897,19951
202003,11380,서울특별시,은평구,50-54세,38860,18907,19953
202004,11380,서울특별시,은평구,50-54세,38951,18944,20007
202005,11380,서울특별시,은평구,50-54세,39066,18996,20070
202006,11380,서울특별시,은평구,50-54세,39246,19073,20173
202001,11380,서울특별시,은평구,55-59세,38416,18311,20105
202002,11380,서울특별시,은평구,55-59세,38294,18283,20011
202003,11380,서울특별시,은평구,55-59세,38091,18166,19925
202004,11380,서울특별시,은평구,55-59세,37993,18114,19879
202005,11380,서울특별시,은평구,55-59세,37992,18081,19911
202006,11380,서울특별시,은평구,55-59세,37828,18017,19811
202001,11380,서울특별시,은평구,60-64세,35794,16740,19054
202002,11380,서울특별시,은평구,60-64세,35905,16782,19123
202003,11380,서울특별시,은평구,60-64세,35706,16684,19022
202004,11380,서울특별시,은평구,60-64세,35755,16730,19025
202005,11380,서울특별시,은평구,60-64세,35811,16792,19019
202006,11380,서울특별시,은평구,60-64세,36116,16928,19188
202001,11380,서울특별시,은평구,65-69세,25590,11665,13925
202002,11380,서울특별시,은평구,65-69세,25777,11724,14053
202003,11380,서울특별시,은평구,65-69세,26260,11919,14341
202004,11380,서울특별시,은평구,65-69세,26412,11968,14444
202005,11380,서울특별시,은평구,65-69세,26486,11975,14511
202006,11380,서울특별시,은평구,65-69세,26569,11999,14570
202001,11380,서울특별시,은평구,70-74세,21357,9466,11891
202002,11380,서울특별시,은평구,70-74세,21408,9504,11904
202003,11380,서울특별시,은평구,70-74세,21390,9506,11884
202004,11380,서울특별시,은평구,70-74세,21414,9516,11898
202005,11380,서울특별시,은평구,70-74세,21511,9572,11939
202006,11380,서울특별시,은평구,70-74세,21569,9587,11982
202001,11380,서울특별시,은평구,75-79세,16922,7478,9444
202002,11380,서울특별시,은평구,75-79세,16925,7464,9461
202003,11380,서울특별시,은평구,75-79세,16991,7495,9496
202004,11380,서울특별시,은평구,75-79세,17041,7514,9527
202005,11380,서울특별시,은평구,75-79세,17103,7516,9587
202006,11380,서울특별시,은평구,75-79세,17221,7562,9659
202001,11380,서울특별시,은평구,80-84세,10471,4374,6097
202002,11380,서울특별시,은평구,80-84세,10529,4406,6123
202003,11380,서울특별시,은평구,80-84세,10550,4416,6134
202004,11380,서울특별시,은평구,80-84세,10600,4451,6149
202005,11380,서울특별시,은평구,80-84세,10679,4512,6167
202006,11380,서울특별시,은평구,80-84세,10712,4531,6181
202001,11380,서울특별시,은평구,85-89세,4276,1483,2793
202002,11380,서울특별시,은평구,85-89세,4351,1504,2847
202003,11380,서울특별시,은평구,85-89세,4410,1523,2887
202004,11380,서울특별시,은평구,85-89세,4454,1541,2913
202005,11380,서울특별시,은평구,85-89세,4483,1560,2923
202006,11380,서울특별시,은평구,85-89세,4523,1575,2948
202001,11380,서울특별시,은평구,90-94세,1576,437,1139
202002,11380,서울특별시,은평구,90-94세,1592,440,1152
202003,11380,서울특별시,은평구,90-94세,1591,444,1147
202004,11380,서울특별시,은평구,90-94세,1597,445,1152
202005,11380,서울특별시,은평구,90-94세,1612,447,1165
202006,11380,서울특별시,은평구,90-94세,1626,450,1176
202001,11380,서울특별시,은평구,95-99세,436,128,308
202002,11380,서울특별시,은평구,95-99세,442,130,312
202003,11380,서울특별시,은평구,95-99세,444,131,313
202004,11380,서울특별시,은평구,95-99세,445,132,313
202005,11380,서울특별시,은평구,95-99세,447,133,314
202006,11380,서울특별시,은평구,95-99세,446,132,314
202001,11380,서울특별시,은평구,100+,403,74,329
202002,11380,서울특별시,은평구,100+,407,75,332
202003,11380,서울특별시,은평구,100+,410,77,333
202004,11380,서울특별시,은평구,100+,412,76,336
202005,11380,서울특별시,은평구,100+,413,78,335
202006,11380,서울특별시,은평구,100+,414,79,335
202001,11410,서울특별시,서대문구,0-4세,9481,4954,4527
202002,11410,서울특별시,서대문구,0-4세,9527,4967,4560
202003,11410,서울특별시,서대문구,0-4세,9547,5002,4545
202004,11410,서울특별시,서대문구,0-4세,9514,4988,4526
202005,11410,서울특별시,서대문구,0-4세,9457,4945,4512
202006,11410,서울특별시,서대문구,0-4세,9352,4901,4451
202001,11410,서울특별시,서대문구,5-9세,10992,5572,5420
202002,11410,서울특별시,서대문구,5-9세,11026,5584,5442
202003,11410,서울특별시,서대문구,5-9세,11127,5633,5494
202004,11410,서울특별시,서대문구,5-9세,11148,5635,5513
202005,11410,서울특별시,서대문구,5-9세,11176,5657,5519
202006,11410,서울특별시,서대문구,5-9세,11174,5642,5532
202001,11410,서울특별시,서대문구,10-14세,10831,5444,5387
202002,11410,서울특별시,서대문구,10-14세,10860,5441,5419
202003,11410,서울특별시,서대문구,10-14세,10922,5468,5454
202004,11410,서울특별시,서대문구,10-14세,10890,5462,5428
202005,11410,서울특별시,서대문구,10-14세,10897,5462,5435
202006,11410,서울특별시,서대문구,10-14세,10885,5462,5423
202001,11410,서울특별시,서대문구,15-19세,13761,6886,6875
202002,11410,서울특별시,서대문구,15-19세,13775,6874,6901
202003,11410,서울특별시,서대문구,15-19세,13711,6819,6892
202004,11410,서울특별시,서대문구,15-19세,13642,6771,6871
202005,11410,서울특별시,서대문구,15-19세,13508,6710,6798
202006,11410,서울특별시,서대문구,15-19세,13416,6671,6745
202001,11410,서울특별시,서대문구,20-24세,22424,10397,12027
202002,11410,서울특별시,서대문구,20-24세,22665,10468,12197
202003,11410,서울특별시,서대문구,20-24세,22819,10528,12291
202004,11410,서울특별시,서대문구,20-24세,22904,10569,12335
202005,11410,서울특별시,서대문구,20-24세,22927,10542,12385
202006,11410,서울특별시,서대문구,20-24세,23011,10555,12456
202001,11410,서울특별시,서대문구,25-29세,26494,13378,13116
202002,11410,서울특별시,서대문구,25-29세,26394,13280,13114
202003,11410,서울특별시,서대문구,25-29세,26711,13469,13242
202004,11410,서울특별시,서대문구,25-29세,26929,13520,13409
202005,11410,서울특별시,서대문구,25-29세,27043,13589,13454
202006,11410,서울특별시,서대문구,25-29세,27151,13635,13516
202001,11410,서울특별시,서대문구,30-34세,21538,10779,10759
202002,11410,서울특별시,서대문구,30-34세,21644,10775,10869
202003,11410,서울특별시,서대문구,30-34세,21780,10818,10962
202004,11410,서울특별시,서대문구,30-34세,21827,10850,10977
202005,11410,서울특별시,서대문구,30-34세,21856,10866,10990
202006,11410,서울특별시,서대문구,30-34세,21898,10864,11034
202001,11410,서울특별시,서대문구,35-39세,23399,11580,11819
202002,11410,서울특별시,서대문구,35-39세,23461,11676,11785
202003,11410,서울특별시,서대문구,35-39세,23578,11714,11864
202004,11410,서울특별시,서대문구,35-39세,23505,11676,11829
202005,11410,서울특별시,서대문구,35-39세,23462,11666,11796
202006,11410,서울특별시,서대문구,35-39세,23326,11594,11732
202001,11410,서울특별시,서대문구,40-44세,21891,10888,11003
202002,11410,서울특별시,서대문구,40-44세,22050,10954,11096
202003,11410,서울특별시,서대문구,40-44세,22098,10969,11129
202004,11410,서울특별시,서대문구,40-44세,22087,10998,11089
202005,11410,서울특별시,서대문구,40-44세,22088,10983,11105
202006,11410,서울특별시,서대문구,40-44세,22094,10955,11139
202001,11410,서울특별시,서대문구,45-49세,26281,12945,13336
202002,11410,서울특별시,서대문구,45-49세,26269,12934,13335
202003,11410,서울특별시,서대문구,45-49세,26296,12958,13338
202004,11410,서울특별시,서대문구,45-49세,26150,12860,13290
202005,11410,서울특별시,서대문구,45-49세,25984,12781,13203
202006,11410,서울특별시,서대문구,45-49세,25887,12754,13133
202001,11410,서울특별시,서대문구,50-54세,25235,12271,12964
202002,11410,서울특별시,서대문구,50-54세,25338,12339,12999
202003,11410,서울특별시,서대문구,50-54세,25352,12340,13012
202004,11410,서울특별시,서대문구,50-54세,25405,12389,13016
202005,11410,서울특별시,서대문구,50-54세,25484,12413,13071
202006,11410,서울특별시,서대문구,50-54세,25476,12411,13065
202001,11410,서울특별시,서대문구,55-59세,24338,11711,12627
202002,11410,서울특별시,서대문구,55-59세,24278,11663,12615
202003,11410,서울특별시,서대문구,55-59세,24302,11707,12595
202004,11410,서울특별시,서대문구,55-59세,24216,11651,12565
202005,11410,서울특별시,서대문구,55-59세,24208,11672,12536
202006,11410,서울특별시,서대문구,55-59세,24068,11606,12462
202001,11410,서울특별시,서대문구,60-64세,21721,10371,11350
202002,11410,서울특별시,서대문구,60-64세,21839,10437,11402
202003,11410,서울특별시,서대문구,60-64세,21831,10407,11424
202004,11410,서울특별시,서대문구,60-64세,21886,10416,11470
202005,11410,서울특별시,서대문구,60-64세,21883,10382,11501
202006,11410,서울특별시,서대문구,60-64세,21974,10427,11547
202001,11410,서울특별시,서대문구,65-69세,15234,6984,8250
202002,11410,서울특별시,서대문구,65-69세,15347,7031,8316
202003,11410,서울특별시,서대문구,65-69세,15527,7140,8387
202004,11410,서울특별시,서대문구,65-69세,15604,7197,8407
202005,11410,서울특별시,서대문구,65-69세,15667,7246,8421
202006,11410,서울특별시,서대문구,65-69세,15761,7304,8457
202001,11410,서울특별시,서대문구,70-74세,13062,5593,7469
202002,11410,서울특별시,서대문구,70-74세,13111,5622,7489
202003,11410,서울특별시,서대문구,70-74세,13159,5653,7506
202004,11410,서울특별시,서대문구,70-74세,13152,5627,7525
202005,11410,서울특별시,서대문구,70-74세,13181,5634,7547
202006,11410,서울특별시,서대문구,70-74세,13171,5622,7549
202001,11410,서울특별시,서대문구,75-79세,11177,4763,6414
202002,11410,서울특별시,서대문구,75-79세,11171,4766,6405
202003,11410,서울특별시,서대문구,75-79세,11191,4751,6440
202004,11410,서울특별시,서대문구,75-79세,11194,4779,6415
202005,11410,서울특별시,서대문구,75-79세,11229,4793,6436
202006,11410,서울특별시,서대문구,75-79세,11247,4797,6450
202001,11410,서울특별시,서대문구,80-84세,7513,3016,4497
202002,11410,서울특별시,서대문구,80-84세,7520,3023,4497
202003,11410,서울특별시,서대문구,80-84세,7581,3047,4534
202004,11410,서울특별시,서대문구,80-84세,7592,3036,4556
202005,11410,서울특별시,서대문구,80-84세,7633,3059,4574
202006,11410,서울특별시,서대문구,80-84세,7600,3047,4553
202001,11410,서울특별시,서대문구,85-89세,3153,1079,2074
202002,11410,서울특별시,서대문구,85-89세,3210,1091,2119
202003,11410,서울특별시,서대문구,85-89세,3237,1111,2126
202004,11410,서울특별시,서대문구,85-89세,3284,1130,2154
202005,11410,서울특별시,서대문구,85-89세,3307,1142,2165
202006,11410,서울특별시,서대문구,85-89세,3349,1153,2196
202001,11410,서울특별시,서대문구,90-94세,1205,341,864
202002,11410,서울특별시,서대문구,90-94세,1218,342,876
202003,11410,서울특별시,서대문구,90-94세,1239,349,890
202004,11410,서울특별시,서대문구,90-94세,1237,349,888
202005,11410,서울특별시,서대문구,90-94세,1243,350,893
202006,11410,서울특별시,서대문구,90-94세,1242,353,889
202001,11410,서울특별시,서대문구,95-99세,346,88,258
202002,11410,서울특별시,서대문구,95-99세,343,89,254
202003,11410,서울특별시,서대문구,95-99세,352,93,259
202004,11410,서울특별시,서대문구,95-99세,362,91,271
202005,11410,서울특별시,서대문구,95-99세,354,91,263
202006,11410,서울특별시,서대문구,95-99세,354,93,261
202001,11410,서울특별시,서대문구,100+,277,74,203
202002,11410,서울특별시,서대문구,100+,281,76,205
202003,11410,서울특별시,서대문구,100+,282,75,207
202004,11410,서울특별시,서대문구,100+,281,75,206
202005,11410,서울특별시,서대문구,100+,282,75,207
202006,11410,서울특별시,서대문구,100+,284,74,210
202001,11440,서울특별시,마포구,0-4세,12676,6515,6161
202002,11440,서울특별시,마포구,0-4세,12582,6463,6119
202003,11440,서울특별시,마포구,0-4세,12531,6414,6117
202004,11440,서울특별시,마포구,0-4세,12412,6360,6052
202005,11440,서울특별시,마포구,0-4세,12343,6322,6021
202006,11440,서울특별시,마포구,0-4세,12205,6262,5943
202001,11440,서울특별시,마포구,5-9세,13694,6868,6826
202002,11440,서울특별시,마포구,5-9세,13643,6853,6790
202003,11440,서울특별시,마포구,5-9세,13674,6877,6797
202004,11440,서울특별시,마포구,5-9세,13691,6887,6804
202005,11440,서울특별시,마포구,5-9세,13666,6862,6804
202006,11440,서울특별시,마포구,5-9세,13675,6859,6816
202001,11440,서울특별시,마포구,10-14세,13831,7021,6810
202002,11440,서울특별시,마포구,10-14세,13823,7037,6786
202003,11440,서울특별시,마포구,10-14세,13752,6991,6761
202004,11440,서울특별시,마포구,10-14세,13768,7013,6755
202005,11440,서울특별시,마포구,10-14세,13790,7026,6764
202006,11440,서울특별시,마포구,10-14세,13793,7028,6765
202001,11440,서울특별시,마포구,15-19세,15752,7928,7824
202002,11440,서울특별시,마포구,15-19세,15743,7872,7871
202003,11440,서울특별시,마포구,15-19세,15705,7874,7831
202004,11440,서울특별시,마포구,15-19세,15569,7805,7764
202005,11440,서울특별시,마포구,15-19세,15434,7735,7699
202006,11440,서울특별시,마포구,15-19세,15321,7667,7654
202001,11440,서울특별시,마포구,20-24세,25565,11568,13997
202002,11440,서울특별시,마포구,20-24세,25827,11633,14194
202003,11440,서울특별시,마포구,20-24세,25970,11690,14280
202004,11440,서울특별시,마포구,20-24세,26010,11664,14346
202005,11440,서울특별시,마포구,20-24세,26130,11720,14410
202006,11440,서울특별시,마포구,20-24세,26122,11665,14457
202001,11440,서울특별시,마포구,25-29세,35196,16186,19010
202002,11440,서울특별시,마포구,25-29세,35015,16138,18877
202003,11440,서울특별시,마포구,25-29세,35195,16204,18991
202004,11440,서울특별시,마포구,25-29세,35217,16237,18980
202005,11440,서울특별시,마포구,25-29세,35438,16312,19126
202006,11440,서울특별시,마포구,25-29세,35551,16347,19204
202001,11440,서울특별시,마포구,30-34세,32114,14807,17307
202002,11440,서울특별시,마포구,30-34세,32136,14823,17313
202003,11440,서울특별시,마포구,30-34세,32116,14784,17332
202004,11440,서울특별시,마포구,30-34세,32147,14792,17355
202005,11440,서울특별시,마포구,30-34세,32321,14872,17449
202006,11440,서울특별시,마포구,30-34세,32295,14833,17462
202001,11440,서울특별시,마포구,35-39세,33395,16293,17102
202002,11440,서울특별시,마포구,35-39세,33264,16225,17039
202003,11440,서울특별시,마포구,35-39세,33239,16194,17045
202004,11440,서울특별시,마포구,35-39세,33188,16137,17051
202005,11440,서울특별시,마포구,35-39세,33165,16162,17003
202006,11440,서울특별시,마포구,35-39세,33064,16139,16925
202001,11440,서울특별시,마포구,40-44세,29597,14281,15316
202002,11440,서울특별시,마포구,40-44세,29681,14328,15353
202003,11440,서울특별시,마포구,40-44세,29568,14301,15267
202004,11440,서울특별시,마포구,40-44세,29491,14277,15214
202005,11440,서울특별시,마포구,40-44세,29445,14239,15206
202006,11440,서울특별시,마포구,40-44세,29388,14206,15182
202001,11440,서울특별시,마포구,45-49세,32874,16138,16736
202002,11440,서울특별시,마포구,45-49세,32959,16150,16809
202003,11440,서울특별시,마포구,45-49세,32812,16069,16743
202004,11440,서울특별시,마포구,45-49세,32762,16038,16724
202005,11440,서울특별시,마포구,45-49세,32679,15994,16685
202006,11440,서울특별시,마포구,45-49세,32544,15933,16611
202001,11440,서울특별시,마포구,50-54세,28265,13960,14305
202002,11440,서울특별시,마포구,50-54세,28329,13981,14348
202003,11440,서울특별시,마포구,50-54세,28373,14001,14372
202004,11440,서울특별시,마포구,50-54세,28404,14038,14366
202005,11440,서울특별시,마포구,50-54세,28462,14040,14422
202006,11440,서울특별시,마포구,50-54세,28472,14033,14439
202001,11440,서울특별시,마포구,55-59세,25993,12701,13292
202002,11440,서울특별시,마포구,55-59세,26028,12760,13268
202003,11440,서울특별시,마포구,55-59세,26036,12759,13277
202004,11440,서울특별시,마포구,55-59세,25989,12735,13254
202005,11440,서울특별시,마포구,55-59세,25993,12751,13242
202006,11440,서울특별시,마포구,55-59세,25841,12697,13144
202001,11440,서울특별시,마포구,60-64세,22617,10583,12034
202002,11440,서울특별시,마포구,60-64세,22711,10621,12090
202003,11440,서울특별시,마포구,60-64세,22687,10614,12073
202004,11440,서울특별시,마포구,60-64세,22691,10630,12061
202005,11440,서울특별시,마포구,60-64세,22698,10623,12075
202006,11440,서울특별시,마포구,60-64세,22785,10652,12133
202001,11440,서울특별시,마포구,65-69세,15567,7022,8545
202002,11440,서울특별시,마포구,65-69세,15649,7071,8578
202003,11440,서울특별시,마포구,65-69세,15868,7181,8687
202004,11440,서울특별시,마포구,65-69세,15957,7234,8723
202005,11440,서울특별시,마포구,65-69세,16051,7294,8757
202006,11440,서울특별시,마포구,65-69세,16075,7282,8793
202001,11440,서울특별시,마포구,70-74세,13236,5553,7683
202002,11440,서울특별시,마포구,70-74세,13235,5545,7690
202003,11440,서울특별시,마포구,70-74세,13264,5549,7715
202004,11440,서울특별시,마포구,70-74세,13237,5531,7706
202005,11440,서울특별시,마포구,70-74세,13253,5543,7710
202006,11440,서울특별시,마포구,70-74세,13256,5551,7705
202001,11440,서울특별시,마포구,75-79세,11160,4802,6358
202002,11440,서울특별시,마포구,75-79세,11172,4797,6375
202003,11440,서울특별시,마포구,75-79세,11155,4796,6359
202004,11440,서울특별시,마포구,75-79세,11207,4812,6395
202005,11440,서울특별시,마포구,75-79세,11233,4812,6421
202006,11440,서울특별시,마포구,75-79세,11266,4829,6437
202001,11440,서울특별시,마포구,80-84세,7244,2886,4358
202002,11440,서울특별시,마포구,80-84세,7274,2902,4372
202003,11440,서울특별시,마포구,80-84세,7299,2922,4377
202004,11440,서울특별시,마포구,80-84세,7308,2929,4379
202005,11440,서울특별시,마포구,80-84세,7325,2928,4397
202006,11440,서울특별시,마포구,80-84세,7320,2924,4396
202001,11440,서울특별시,마포구,85-89세,3312,1163,2149
202002,11440,서울특별시,마포구,85-89세,3363,1181,2182
202003,11440,서울특별시,마포구,85-89세,3424,1204,2220
202004,11440,서울특별시,마포구,85-89세,3464,1217,2247
202005,11440,서울특별시,마포구,85-89세,3471,1223,2248
202006,11440,서울특별시,마포구,85-89세,3477,1224,2253
202001,11440,서울특별시,마포구,90-94세,1195,330,865
202002,11440,서울특별시,마포구,90-94세,1207,332,875
202003,11440,서울특별시,마포구,90-94세,1215,337,878
202004,11440,서울특별시,마포구,90-94세,1216,334,882
202005,11440,서울특별시,마포구,90-94세,1236,338,898
202006,11440,서울특별시,마포구,90-94세,1243,346,897
202001,11440,서울특별시,마포구,95-99세,351,100,251
202002,11440,서울특별시,마포구,95-99세,351,97,254
202003,11440,서울특별시,마포구,95-99세,364,103,261
202004,11440,서울특별시,마포구,95-99세,374,107,267
202005,11440,서울특별시,마포구,95-99세,379,110,269
202006,11440,서울특별시,마포구,95-99세,371,107,264
202001,11440,서울특별시,마포구,100+,317,77,240
202002,11440,서울특별시,마포구,100+,323,80,243
202003,11440,서울특별시,마포구,100+,323,79,244
202004,11440,서울특별시,마포구,100+,324,79,245
202005,11440,서울특별시,마포구,100+,325,79,246
202006,11440,서울특별시,마포구,100+,326,80,246
202001,11470,서울특별시,양천구,0-4세,13080,6713,6367
202002,11470,서울특별시,양천구,0-4세,12987,6682,6305
202003,11470,서울특별시,양천구,0-4세,12826,6599,6227
202004,11470,서울특별시,양천구,0-4세,12874,6618,6256
202005,11470,서울특별시,양천구,0-4세,12895,6632,6263
202006,11470,서울특별시,양천구,0-4세,12731,6520,6211
202001,11470,서울특별시,양천구,5-9세,20021,10318,9703
202002,11470,서울특별시,양천구,5-9세,20223,10415,9808
202003,11470,서울특별시,양천구,5-9세,20124,10365,9759
202004,11470,서울특별시,양천구,5-9세,20155,10369,9786
202005,11470,서울특별시,양천구,5-9세,20188,10361,9827
202006,11470,서울특별시,양천구,5-9세,20189,10374,9815
202001,11470,서울특별시,양천구,10-14세,24442,12754,11688
202002,11470,서울특별시,양천구,10-14세,24536,12816,11720
202003,11470,서울특별시,양천구,10-14세,24519,12831,11688
202004,11470,서울특별시,양천구,10-14세,24558,12834,11724
202005,11470,서울특별시,양천구,10-14세,24555,12843,11712
202006,11470,서울특별시,양천구,10-14세,24534,12820,11714
202001,11470,서울특별시,양천구,15-19세,27988,14615,13373
202002,11470,서울특별시,양천구,15-19세,27629,14399,13230
202003,11470,서울특별시,양천구,15-19세,27335,14225,13110
202004,11470,서울특별시,양천구,15-19세,27232,14162,13070
202005,11470,서울특별시,양천구,15-19세,27109,14091,13018
202006,11470,서울특별시,양천구,15-19세,26911,13967,12944
202001,11470,서울특별시,양천구,20-24세,30188,15733,14455
202002,11470,서울특별시,양천구,20-24세,29944,15610,14334
202003,11470,서울특별시,양천구,20-24세,29781,15537,14244
202004,11470,서울특별시,양천구,20-24세,29717,15502,14215
202005,11470,서울특별시,양천구,20-24세,29759,15544,14215
202006,11470,서울특별시,양천구,20-24세,29705,15531,14174
202001,11470,서울특별시,양천구,25-29세,30640,15458,15182
202002,11470,서울특별시,양천구,25-29세,30449,15353,15096
202003,11470,서울특별시,양천구,25-29세,30657,15453,15204
202004,11470,서울특별시,양천구,25-29세,30752,15513,15239
202005,11470,서울특별시,양천구,25-29세,30907,15571,15336
202006,11470,서울특별시,양천구,25-29세,30941,15547,15394
202001,11470,서울특별시,양천구,30-34세,26792,13271,13521
202002,11470,서울특별시,양천구,30-34세,26778,13268,13510
202003,11470,서울특별시,양천구,30-34세,26609,13247,13362
202004,11470,서울특별시,양천구,30-34세,26763,13331,13432
202005,11470,서울특별시,양천구,30-34세,26970,13454,13516
202006,11470,서울특별시,양천구,30-34세,27067,13535,13532
202001,11470,서울특별시,양천구,35-39세,32725,15929,16796
202002,11470,서울특별시,양천구,35-39세,32631,15838,16793
202003,11470,서울특별시,양천구,35-39세,32405,15747,16658
202004,11470,서울특별시,양천구,35-39세,32471,15778,16693
202005,11470,서울특별시,양천구,35-39세,32557,15841,16716
202006,11470,서울특별시,양천구,35-39세,32427,15746,16681
202001,11470,서울특별시,양천구,40-44세,36014,16982,19032
202002,11470,서울특별시,양천구,40-44세,36311,17147,19164
202003,11470,서울특별시,양천구,40-44세,36213,17085,19128
202004,11470,서울특별시,양천구,40-44세,36252,17098,19154
202005,11470,서울특별시,양천구,40-44세,36275,17137,19138
202006,11470,서울특별시,양천구,40-44세,36257,17149,19108
202001,11470,서울특별시,양천구,45-49세,44702,21669,23033
202002,11470,서울특별시,양천구,45-49세,44506,21596,22910
202003,11470,서울특별시,양천구,45-49세,44194,21419,22775
202004,11470,서울특별시,양천구,45-49세,44077,21355,22722
202005,11470,서울특별시,양천구,45-49세,44000,21311,22689
202006,11470,서울특별시,양천구,45-49세,43829,21226,22603
202001,11470,서울특별시,양천구,50-54세,40268,20055,20213
202002,11470,서울특별시,양천구,50-54세,40073,19970,20103
202003,11470,서울특별시,양천구,50-54세,39991,19962,20029
202004,11470,서울특별시,양천구,50-54세,40087,19997,20090
202005,11470,서울특별시,양천구,50-54세,40286,20094,20192
202006,11470,서울특별시,양천구,50-54세,40334,20112,20222
202001,11470,서울특별시,양천구,55-59세,37065,18403,18662
202002,11470,서울특별시,양천구,55-59세,36895,18299,18596
202003,11470,서울특별시,양천구,55-59세,36788,18221,18567
202004,11470,서울특별시,양천구,55-59세,36738,18206,18532
202005,11470,서울특별시,양천구,55-59세,36781,18203,18578
202006,11470,서울특별시,양천구,55-59세,36635,18157,18478
202001,11470,서울특별시,양천구,60-64세,32370,15494,16876
202002,11470,서울특별시,양천구,60-64세,32410,15546,16864
202003,11470,서울특별시,양천구,60-64세,32275,15507,16768
202004,11470,서울특별시,양천구,60-64세,32427,15554,16873
202005,11470,서울특별시,양천구,60-64세,32518,15594,16924
202006,11470,서울특별시,양천구,60-64세,32706,15657,17049
202001,11470,서울특별시,양천구,65-69세,22329,10897,11432
202002,11470,서울특별시,양천구,65-69세,22559,10988,11571
202003,11470,서울특별시,양천구,65-69세,22973,11148,11825
202004,11470,서울특별시,양천구,65-69세,23156,11244,11912
202005,11470,서울특별시,양천구,65-69세,23276,11279,11997
202006,11470,서울특별시,양천구,65-69세,23426,11363,12063
202001,11470,서울특별시,양천구,70-74세,16043,7674,8369
202002,11470,서울특별시,양천구,70-74세,16102,7686,8416
202003,11470,서울특별시,양천구,70-74세,16191,7745,8446
202004,11470,서울특별시,양천구,70-74세,16257,7811,8446
202005,11470,서울특별시,양천구,70-74세,16394,7898,8496
202006,11470,서울특별시,양천구,70-74세,16490,7937,8553
202001,11470,서울특별시,양천구,75-79세,11223,5073,6150
202002,11470,서울특별시,양천구,75-79세,11248,5116,6132
202003,11470,서울특별시,양천구,75-79세,11284,5133,6151
202004,11470,서울특별시,양천구,75-79세,11352,5151,6201
202005,11470,서울특별시,양천구,75-79세,11405,5177,6228
202006,11470,서울특별시,양천구,75-79세,11448,5192,6256
202001,11470,서울특별시,양천구,80-84세,6837,2547,4290
202002,11470,서울특별시,양천구,80-84세,6859,2545,4314
202003,11470,서울특별시,양천구,80-84세,6911,2572,4339
202004,11470,서울특별시,양천구,80-84세,6957,2590,4367
202005,11470,서울특별시,양천구,80-84세,7014,2611,4403
202006,11470,서울특별시,양천구,80-84세,7014,2623,4391
202001,11470,서울특별시,양천구,85-89세,3392,971,2421
202002,11470,서울특별시,양천구,85-89세,3416,986,2430
202003,11470,서울특별시,양천구,85-89세,3463,999,2464
202004,11470,서울특별시,양천구,85-89세,3483,1003,2480
202005,11470,서울특별시,양천구,85-89세,3467,995,2472
202006,11470,서울특별시,양천구,85-89세,3469,999,2470
202001,11470,서울특별시,양천구,90-94세,1253,314,939
202002,11470,서울특별시,양천구,90-94세,1245,317,928
202003,11470,서울특별시,양천구,90-94세,1263,320,943
202004,11470,서울특별시,양천구,90-94세,1283,321,962
202005,11470,서울특별시,양천구,90-94세,1291,325,966
202006,11470,서울특별시,양천구,90-94세,1302,330,972
202001,11470,서울특별시,양천구,95-99세,345,83,262
202002,11470,서울특별시,양천구,95-99세,363,84,279
202003,11470,서울특별시,양천구,95-99세,365,82,283
202004,11470,서울특별시,양천구,95-99세,369,82,287
202005,11470,서울특별시,양천구,95-99세,361,79,282
202006,11470,서울특별시,양천구,95-99세,365,79,286
202001,11470,서울특별시,양천구,100+,170,42,128
202002,11470,서울특별시,양천구,100+,168,41,127
202003,11470,서울특별시,양천구,100+,172,44,128
202004,11470,서울특별시,양천구,100+,172,44,128
202005,11470,서울특별시,양천구,100+,173,44,129
202006,11470,서울특별시,양천구,100+,173,44,129
202001,11500,서울특별시,강서구,0-4세,20465,10498,9967
202002,11500,서울특별시,강서구,0-4세,20144,10346,9798
202003,11500,서울특별시,강서구,0-4세,19804,10189,9615
202004,11500,서울특별시,강서구,0-4세,19534,10043,9491
202005,11500,서울특별시,강서구,0-4세,19305,9904,9401
202006,11500,서울특별시,강서구,0-4세,19091,9779,9312
202001,11500,서울특별시,강서구,5-9세,23277,11824,11453
202002,11500,서울특별시,강서구,5-9세,23129,11756,11373
202003,11500,서울특별시,강서구,5-9세,23036,11720,11316
202004,11500,서울특별시,강서구,5-9세,22940,11660,11280
202005,11500,서울특별시,강서구,5-9세,22878,11629,11249
202006,11500,서울특별시,강서구,5-9세,22807,11602,11205
202001,11500,서울특별시,강서구,10-14세,21512,11051,10461
202002,11500,서울특별시,강서구,10-14세,21460,11034,10426
202003,11500,서울특별시,강서구,10-14세,21431,11023,10408
202004,11500,서울특별시,강서구,10-14세,21431,11043,10388
202005,11500,서울특별시,강서구,10-14세,21382,11015,10367
202006,11500,서울특별시,강서구,10-14세,21458,11041,10417
202001,11500,서울특별시,강서구,15-19세,25599,12981,12618
202002,11500,서울특별시,강서구,15-19세,25356,12819,12537
202003,11500,서울특별시,강서구,15-19세,25180,12698,12482
202004,11500,서울특별시,강서구,15-19세,24960,12602,12358
202005,11500,서울특별시,강서구,15-19세,24802,12514,12288
202006,11500,서울특별시,강서구,15-19세,24637,12462,12175
202001,11500,서울특별시,강서구,20-24세,35423,16984,18439
202002,11500,서울특별시,강서구,20-24세,35366,16868,18498
202003,11500,서울특별시,강서구,20-24세,35305,16827,18478
202004,11500,서울특별시,강서구,20-24세,35229,16762,18467
202005,11500,서울특별시,강서구,20-24세,35110,16697,18413
202006,11500,서울특별시,강서구,20-24세,35114,16643,18471
202001,11500,서울특별시,강서구,25-29세,52013,24184,27829
202002,11500,서울특별시,강서구,25-29세,51837,24071,27766
202003,11500,서울특별시,강서구,25-29세,52181,24201,27980
202004,11500,서울특별시,강서구,25-29세,52257,24188,28069
202005,11500,서울특별시,강서구,25-29세,52258,24130,28128
202006,11500,서울특별시,강서구,25-29세,52260,24125,28135
202001,11500,서울특별시,강서구,30-34세,49840,24815,25025
202002,11500,서울특별시,강서구,30-34세,49743,24757,24986
202003,11500,서울특별시,강서구,30-34세,49556,24735,24821
202004,11500,서울특별시,강서구,30-34세,49546,24765,24781
202005,11500,서울특별시,강서구,30-34세,49662,24839,24823
202006,11500,서울특별시,강서구,30-34세,49730,24863,24867
202001,11500,서울특별시,강서구,35-39세,52966,27225,25741
202002,11500,서울특별시,강서구,35-39세,52572,27085,25487
202003,11500,서울특별시,강서구,35-39세,52109,26816,25293
202004,11500,서울특별시,강서구,35-39세,51690,26612,25078
202005,11500,서울특별시,강서구,35-39세,51457,26500,24957
202006,11500,서울특별시,강서구,35-39세,51181,26356,24825
202001,11500,서울특별시,강서구,40-44세,45475,22897,22578
202002,11500,서울특별시,강서구,40-44세,45554,22917,22637
202003,11500,서울특별시,강서구,40-44세,45454,22850,22604
202004,11500,서울특별시,강서구,40-44세,45339,22788,22551
202005,11500,서울특별시,강서구,40-44세,45333,22790,22543
202006,11500,서울특별시,강서구,40-44세,45314,22779,22535
202001,11500,서울특별시,강서구,45-49세,47882,23992,23890
202002,11500,서울특별시,강서구,45-49세,47779,23964,23815
202003,11500,서울특별시,강서구,45-49세,47488,23853,23635
202004,11500,서울특별시,강서구,45-49세,47392,23793,23599
202005,11500,서울특별시,강서구,45-49세,47150,23657,23493
202006,11500,서울특별시,강서구,45-49세,47072,23578,23494
202001,11500,서울특별시,강서구,50-54세,43319,20832,22487
202002,11500,서울특별시,강서구,50-54세,43254,20800,22454
202003,11500,서울특별시,강서구,50-54세,43123,20786,22337
202004,11500,서울특별시,강서구,50-54세,43043,20784,22259
202005,11500,서울특별시,강서구,50-54세,43039,20790,22249
202006,11500,서울특별시,강서구,50-54세,43072,20819,22253
202001,11500,서울특별시,강서구,55-59세,45612,21452,24160
202002,11500,서울특별시,강서구,55-59세,45457,21404,24053
202003,11500,서울특별시,강서구,55-59세,45300,21329,23971
202004,11500,서울특별시,강서구,55-59세,45121,21248,23873
202005,11500,서울특별시,강서구,55-59세,44988,21204,23784
202006,11500,서울특별시,강서구,55-59세,44622,21051,23571
202001,11500,서울특별시,강서구,60-64세,43757,20302,23455
202002,11500,서울특별시,강서구,60-64세,43811,20305,23506
202003,11500,서울특별시,강서구,60-64세,43622,20239,23383
202004,11500,서울특별시,강서구,60-64세,43666,20254,23412
202005,11500,서울특별시,강서구,60-64세,43685,20281,23404
202006,11500,서울특별시,강서구,60-64세,43816,20360,23456
202001,11500,서울특별시,강서구,65-69세,30163,14111,16052
202002,11500,서울특별시,강서구,65-69세,30434,14214,16220
202003,11500,서울특별시,강서구,65-69세,30902,14387,16515
202004,11500,서울특별시,강서구,65-69세,31049,14424,16625
202005,11500,서울특별시,강서구,65-69세,31163,14460,16703
202006,11500,서울특별시,강서구,65-69세,31314,14506,16808
202001,11500,서울특별시,강서구,70-74세,22450,10750,11700
202002,11500,서울특별시,강서구,70-74세,22548,10799,11749
202003,11500,서울특별시,강서구,70-74세,22685,10864,11821
202004,11500,서울특별시,강서구,70-74세,22766,10900,11866
202005,11500,서울특별시,강서구,70-74세,22823,10924,11899
202006,11500,서울특별시,강서구,70-74세,22877,10915,11962
202001,11500,서울특별시,강서구,75-79세,15301,6926,8375
202002,11500,서울특별시,강서구,75-79세,15324,6944,8380
202003,11500,서울특별시,강서구,75-79세,15345,6975,8370
202004,11500,서울특별시,강서구,75-79세,15441,7031,8410
202005,11500,서울특별시,강서구,75-79세,15541,7085,8456
202006,11500,서울특별시,강서구,75-79세,15547,7110,8437
202001,11500,서울특별시,강서구,80-84세,9361,3483,5878
202002,11500,서울특별시,강서구,80-84세,9392,3501,5891
202003,11500,서울특별시,강서구,80-84세,9454,3525,5929
202004,11500,서울특별시,강서구,80-84세,9484,3549,5935
202005,11500,서울특별시,강서구,80-84세,9546,3590,5956
202006,11500,서울특별시,강서구,80-84세,9577,3607,5970
202001,11500,서울특별시,강서구,85-89세,4636,1386,3250
202002,11500,서울특별시,강서구,85-89세,4690,1418,3272
202003,11500,서울특별시,강서구,85-89세,4734,1447,3287
202004,11500,서울특별시,강서구,85-89세,4776,1471,3305
202005,11500,서울특별시,강서구,85-89세,4796,1469,3327
202006,11500,서울특별시,강서구,85-89세,4801,1473,3328
202001,11500,서울특별시,강서구,90-94세,1858,423,1435
202002,11500,서울특별시,강서구,90-94세,1885,426,1459
202003,11500,서울특별시,강서구,90-94세,1897,429,1468
202004,11500,서울특별시,강서구,90-94세,1911,429,1482
202005,11500,서울특별시,강서구,90-94세,1915,435,1480
202006,11500,서울특별시,강서구,90-94세,1939,433,1506
202001,11500,서울특별시,강서구,95-99세,468,127,341
202002,11500,서울특별시,강서구,95-99세,462,123,339
202003,11500,서울특별시,강서구,95-99세,474,124,350
202004,11500,서울특별시,강서구,95-99세,481,128,353
202005,11500,서울특별시,강서구,95-99세,487,128,359
202006,11500,서울특별시,강서구,95-99세,478,123,355
202001,11500,서울특별시,강서구,100+,222,66,156
202002,11500,서울특별시,강서구,100+,222,68,154
202003,11500,서울특별시,강서구,100+,222,68,154
202004,11500,서울특별시,강서구,100+,225,69,156
202005,11500,서울특별시,강서구,100+,233,74,159
202006,11500,서울특별시,강서구,100+,229,72,157
202001,11530,서울특별시,구로구,0-4세,14313,7367,6946
202002,11530,서울특별시,구로구,0-4세,14175,7297,6878
202003,11530,서울특별시,구로구,0-4세,13998,7201,6797
202004,11530,서울특별시,구로구,0-4세,13834,7113,6721
202005,11530,서울특별시,구로구,0-4세,13618,7004,6614
202006,11530,서울특별시,구로구,0-4세,13520,6972,6548
202001,11530,서울특별시,구로구,5-9세,16079,8157,7922
202002,11530,서울특별시,구로구,5-9세,15942,8093,7849
202003,11530,서울특별시,구로구,5-9세,15873,8052,7821
202004,11530,서울특별시,구로구,5-9세,15826,8044,7782
202005,11530,서울특별시,구로구,5-9세,15797,8026,7771
202006,11530,서울특별시,구로구,5-9세,15785,8018,7767
202001,11530,서울특별시,구로구,10-14세,14603,7472,7131
202002,11530,서울특별시,구로구,10-14세,14501,7419,7082
202003,11530,서울특별시,구로구,10-14세,14546,7433,7113
202004,11530,서울특별시,구로구,10-14세,14548,7443,7105
202005,11530,서울특별시,구로구,10-14세,14606,7468,7138
202006,11530,서울특별시,구로구,10-14세,14643,7473,7170
202001,11530,서울특별시,구로구,15-19세,16781,8712,8069
202002,11530,서울특별시,구로구,15-19세,16631,8631,8000
202003,11530,서울특별시,구로구,15-19세,16509,8567,7942
202004,11530,서울특별시,구로구,15-19세,16352,8491,7861
202005,11530,서울특별시,구로구,15-19세,16206,8410,7796
202006,11530,서울특별시,구로구,15-19세,16076,8357,7719
202001,11530,서울특별시,구로구,20-24세,24149,11869,12280
202002,11530,서울특별시,구로구,20-24세,24150,11869,12281
202003,11530,서울특별시,구로구,20-24세,24036,11803,12233
202004,11530,서울특별시,구로구,20-24세,23987,11778,12209
202005,11530,서울특별시,구로구,20-24세,23986,11767,12219
202006,11530,서울특별시,구로구,20-24세,23971,11729,12242
202001,11530,서울특별시,구로구,25-29세,31518,15504,16014
202002,11530,서울특별시,구로구,25-29세,31367,15421,15946
202003,11530,서울특별시,구로구,25-29세,31561,15533,16028
202004,11530,서울특별시,구로구,25-29세,31548,15533,16015
202005,11530,서울특별시,구로구,25-29세,31558,15508,16050
202006,11530,서울특별시,구로구,25-29세,31636,15527,16109
202001,11530,서울특별시,구로구,30-34세,30275,15270,15005
202002,11530,서울특별시,구로구,30-34세,30407,15371,15036
202003,11530,서울특별시,구로구,30-34세,30445,15379,15066
202004,11530,서울특별시,구로구,30-34세,30388,15342,15046
202005,11530,서울특별시,구로구,30-34세,30392,15355,15037
202006,11530,서울특별시,구로구,30-34세,30434,15351,15083
202001,11530,서울특별시,구로구,35-39세,34272,17609,16663
202002,11530,서울특별시,구로구,35-39세,33968,17496,16472
202003,11530,서울특별시,구로구,35-39세,33774,17381,16393
202004,11530,서울특별시,구로구,35-39세,33523,17296,16227
202005,11530,서울특별시,구로구,35-39세,33332,17193,16139
202006,11530,서울특별시,구로구,35-39세,33292,17209,16083
202001,11530,서울특별시,구로구,40-44세,31008,15974,15034
202002,11530,서울특별시,구로구,40-44세,31038,15978,15060
202003,11530,서울특별시,구로구,40-44세,30942,15904,15038
202004,11530,서울특별시,구로구,40-44세,30896,15832,15064
202005,11530,서울특별시,구로구,40-44세,30952,15880,15072
202006,11530,서울특별시,구로구,40-44세,30939,15833,15106
202001,11530,서울특별시,구로구,45-49세,33506,17219,16287
202002,11530,서울특별시,구로구,45-49세,33336,17131,16205
202003,11530,서울특별시,구로구,45-49세,33146,17034,16112
202004,11530,서울특별시,구로구,45-49세,33053,16968,16085
202005,11530,서울특별시,구로구,45-49세,32963,16931,16032
202006,11530,서울특별시,구로구,45-49세,32902,16926,15976
202001,11530,서울특별시,구로구,50-54세,31420,15529,15891
202002,11530,서울특별시,구로구,50-54세,31471,15574,15897
202003,11530,서울특별시,구로구,50-54세,31436,15563,15873
202004,11530,서울특별시,구로구,50-54세,31480,15580,15900
202005,11530,서울특별시,구로구,50-54세,31496,15605,15891
202006,11530,서울특별시,구로구,50-54세,31503,15614,15889
202001,11530,서울특별시,구로구,55-59세,32440,15843,16597
202002,11530,서울특별시,구로구,55-59세,32381,15838,16543
202003,11530,서울특별시,구로구,55-59세,32228,15787,16441
202004,11530,서울특별시,구로구,55-59세,32104,15726,16378
202005,11530,서울특별시,구로구,55-59세,32072,15709,16363
202006,11530,서울특별시,구로구,55-59세,31879,15658,16221
202001,11530,서울특별시,구로구,60-64세,30974,14684,16290
202002,11530,서울특별시,구로구,60-64세,31045,14700,16345
202003,11530,서울특별시,구로구,60-64세,30960,14656,16304
202004,11530,서울특별시,구로구,60-64세,31006,14707,16299
202005,11530,서울특별시,구로구,60-64세,31003,14714,16289
202006,11530,서울특별시,구로구,60-64세,31246,14808,16438
202001,11530,서울특별시,구로구,65-69세,22643,10663,11980
202002,11530,서울특별시,구로구,65-69세,22818,10739,12079
202003,11530,서울특별시,구로구,65-69세,23080,10851,12229
202004,11530,서울특별시,구로구,65-69세,23210,10899,12311
202005,11530,서울특별시,구로구,65-69세,23319,10945,12374
202006,11530,서울특별시,구로구,65-69세,23378,10984,12394
202001,11530,서울특별시,구로구,70-74세,17841,8634,9207
202002,11530,서울특별시,구로구,70-74세,17911,8659,9252
202003,11530,서울특별시,구로구,70-74세,18037,8706,9331
202004,11530,서울특별시,구로구,70-74세,18079,8710,9369
202005,11530,서울특별시,구로구,70-74세,18131,8755,9376
202006,11530,서울특별시,구로구,70-74세,18185,8779,9406
202001,11530,서울특별시,구로구,75-79세,12802,5981,6821
202002,11530,서울특별시,구로구,75-79세,12847,6009,6838
202003,11530,서울특별시,구로구,75-79세,12868,6021,6847
202004,11530,서울특별시,구로구,75-79세,12948,6066,6882
202005,11530,서울특별시,구로구,75-79세,13038,6092,6946
202006,11530,서울특별시,구로구,75-79세,13079,6100,6979
202001,11530,서울특별시,구로구,80-84세,7406,3144,4262
202002,11530,서울특별시,구로구,80-84세,7483,3177,4306
202003,11530,서울특별시,구로구,80-84세,7559,3204,4355
202004,11530,서울특별시,구로구,80-84세,7589,3213,4376
202005,11530,서울특별시,구로구,80-84세,7637,3231,4406
202006,11530,서울특별시,구로구,80-84세,7673,3249,4424
202001,11530,서울특별시,구로구,85-89세,3158,1053,2105
202002,11530,서울특별시,구로구,85-89세,3193,1064,2129
202003,11530,서울특별시,구로구,85-89세,3230,1087,2143
202004,11530,서울특별시,구로구,85-89세,3293,1111,2182
202005,11530,서울특별시,구로구,85-89세,3309,1117,2192
202006,11530,서울특별시,구로구,85-89세,3318,1122,2196
202001,11530,서울특별시,구로구,90-94세,1110,272,838
202002,11530,서울특별시,구로구,90-94세,1120,277,843
202003,11530,서울특별시,구로구,90-94세,1144,287,857
202004,11530,서울특별시,구로구,90-94세,1141,279,862
202005,11530,서울특별시,구로구,90-94세,1141,278,863
202006,11530,서울특별시,구로구,90-94세,1143,278,865
202001,11530,서울특별시,구로구,95-99세,293,75,218
202002,11530,서울특별시,구로구,95-99세,299,76,223
202003,11530,서울특별시,구로구,95-99세,300,72,228
202004,11530,서울특별시,구로구,95-99세,299,71,228
202005,11530,서울특별시,구로구,95-99세,305,73,232
202006,11530,서울특별시,구로구,95-99세,305,74,231
202001,11530,서울특별시,구로구,100+,160,34,126
202002,11530,서울특별시,구로구,100+,162,35,127
202003,11530,서울특별시,구로구,100+,165,37,128
202004,11530,서울특별시,구로구,100+,167,37,130
202005,11530,서울특별시,구로구,100+,169,37,132
202006,11530,서울특별시,구로구,100+,168,37,131
202001,11545,서울특별시,금천구,0-4세,6561,3395,3166
202002,11545,서울특별시,금천구,0-4세,6478,3355,3123
202003,11545,서울특별시,금천구,0-4세,6366,3295,3071
202004,11545,서울특별시,금천구,0-4세,6286,3248,3038
202005,11545,서울특별시,금천구,0-4세,6243,3236,3007
202006,11545,서울특별시,금천구,0-4세,6175,3201,2974
202001,11545,서울특별시,금천구,5-9세,7135,3627,3508
202002,11545,서울특별시,금천구,5-9세,7051,3570,3481
202003,11545,서울특별시,금천구,5-9세,7039,3566,3473
202004,11545,서울특별시,금천구,5-9세,7033,3559,3474
202005,11545,서울특별시,금천구,5-9세,7015,3547,3468
202006,11545,서울특별시,금천구,5-9세,7002,3530,3472
202001,11545,서울특별시,금천구,10-14세,6848,3481,3367
202002,11545,서울특별시,금천구,10-14세,6825,3479,3346
202003,11545,서울특별시,금천구,10-14세,6813,3474,3339
202004,11545,서울특별시,금천구,10-14세,6820,3474,3346
202005,11545,서울특별시,금천구,10-14세,6807,3465,3342
202006,11545,서울특별시,금천구,10-14세,6791,3454,3337
202001,11545,서울특별시,금천구,15-19세,8853,4530,4323
202002,11545,서울특별시,금천구,15-19세,8720,4436,4284
202003,11545,서울특별시,금천구,15-19세,8633,4378,4255
202004,11545,서울특별시,금천구,15-19세,8553,4322,4231
202005,11545,서울특별시,금천구,15-19세,8483,4281,4202
202006,11545,서울특별시,금천구,15-19세,8393,4241,4152
202001,11545,서울특별시,금천구,20-24세,14818,7345,7473
202002,11545,서울특별시,금천구,20-24세,14823,7309,7514
202003,11545,서울특별시,금천구,20-24세,14745,7269,7476
202004,11545,서울특별시,금천구,20-24세,14738,7277,7461
202005,11545,서울특별시,금천구,20-24세,14703,7248,7455
202006,11545,서울특별시,금천구,20-24세,14689,7224,7465
202001,11545,서울특별시,금천구,25-29세,21544,11277,10267
202002,11545,서울특별시,금천구,25-29세,21568,11305,10263
202003,11545,서울특별시,금천구,25-29세,21772,11438,10334
202004,11545,서울특별시,금천구,25-29세,21817,11429,10388
202005,11545,서울특별시,금천구,25-29세,21883,11453,10430
202006,11545,서울특별시,금천구,25-29세,21990,11504,10486
202001,11545,서울특별시,금천구,30-34세,18050,10000,8050
202002,11545,서울특별시,금천구,30-34세,18106,10048,8058
202003,11545,서울특별시,금천구,30-34세,18117,10044,8073
202004,11545,서울특별시,금천구,30-34세,18140,10091,8049
202005,11545,서울특별시,금천구,30-34세,18249,10144,8105
202006,11545,서울특별시,금천구,30-34세,18262,10134,8128
202001,11545,서울특별시,금천구,35-39세,17644,9713,7931
202002,11545,서울특별시,금천구,35-39세,17546,9657,7889
202003,11545,서울특별시,금천구,35-39세,17406,9603,7803
202004,11545,서울특별시,금천구,35-39세,17365,9595,7770
202005,11545,서울특별시,금천구,35-39세,17363,9569,7794
202006,11545,서울특별시,금천구,35-39세,17283,9551,7732
202001,11545,서울특별시,금천구,40-44세,15534,8249,7285
202002,11545,서울특별시,금천구,40-44세,15573,8292,7281
202003,11545,서울특별시,금천구,40-44세,15511,8243,7268
202004,11545,서울특별시,금천구,40-44세,15431,8204,7227
202005,11545,서울특별시,금천구,40-44세,15327,8162,7165
202006,11545,서울특별시,금천구,40-44세,15308,8142,7166
202001,11545,서울특별시,금천구,45-49세,18665,9593,9072
202002,11545,서울특별시,금천구,45-49세,18542,9511,9031
202003,11545,서울특별시,금천구,45-49세,18398,9456,8942
202004,11545,서울특별시,금천구,45-49세,18379,9436,8943
202005,11545,서울특별시,금천구,45-49세,18283,9379,8904
202006,11545,서울특별시,금천구,45-49세,18213,9349,8864
202001,11545,서울특별시,금천구,50-54세,20010,10020,9990
202002,11545,서울특별시,금천구,50-54세,19957,10008,9949
202003,11545,서울특별시,금천구,50-54세,19924,9991,9933
202004,11545,서울특별시,금천구,50-54세,19841,9949,9892
202005,11545,서울특별시,금천구,50-54세,19858,9956,9902
202006,11545,서울특별시,금천구,50-54세,19800,9908,9892
202001,11545,서울특별시,금천구,55-59세,21276,10732,10544
202002,11545,서울특별시,금천구,55-59세,21217,10696,10521
202003,11545,서울특별시,금천구,55-59세,21188,10688,10500
202004,11545,서울특별시,금천구,55-59세,21121,10676,10445
202005,11545,서울특별시,금천구,55-59세,21130,10687,10443
202006,11545,서울특별시,금천구,55-59세,20964,10610,10354
202001,11545,서울특별시,금천구,60-64세,18730,9299,9431
202002,11545,서울특별시,금천구,60-64세,18815,9352,9463
202003,11545,서울특별시,금천구,60-64세,18723,9310,9413
202004,11545,서울특별시,금천구,60-64세,18787,9341,9446
202005,11545,서울특별시,금천구,60-64세,18803,9339,9464
202006,11545,서울특별시,금천구,60-64세,18976,9449,9527
202001,11545,서울특별시,금천구,65-69세,12916,6239,6677
202002,11545,서울특별시,금천구,65-69세,12990,6283,6707
202003,11545,서울특별시,금천구,65-69세,13195,6381,6814
202004,11545,서울특별시,금천구,65-69세,13233,6379,6854
202005,11545,서울특별시,금천구,65-69세,13285,6407,6878
202006,11545,서울특별시,금천구,65-69세,13324,6411,6913
202001,11545,서울특별시,금천구,70-74세,10077,4750,5327
202002,11545,서울특별시,금천구,70-74세,10112,4754,5358
202003,11545,서울특별시,금천구,70-74세,10138,4775,5363
202004,11545,서울특별시,금천구,70-74세,10152,4786,5366
202005,11545,서울특별시,금천구,70-74세,10194,4816,5378
202006,11545,서울특별시,금천구,70-74세,10194,4810,5384
202001,11545,서울특별시,금천구,75-79세,7468,3434,4034
202002,11545,서울특별시,금천구,75-79세,7481,3451,4030
202003,11545,서울특별시,금천구,75-79세,7511,3462,4049
202004,11545,서울특별시,금천구,75-79세,7529,3467,4062
202005,11545,서울특별시,금천구,75-79세,7569,3477,4092
202006,11545,서울특별시,금천구,75-79세,7636,3510,4126
202001,11545,서울특별시,금천구,80-84세,4174,1754,2420
202002,11545,서울특별시,금천구,80-84세,4226,1765,2461
202003,11545,서울특별시,금천구,80-84세,4259,1786,2473
202004,11545,서울특별시,금천구,80-84세,4294,1805,2489
202005,11545,서울특별시,금천구,80-84세,4329,1826,2503
202006,11545,서울특별시,금천구,80-84세,4334,1821,2513
202001,11545,서울특별시,금천구,85-89세,1822,620,1202
202002,11545,서울특별시,금천구,85-89세,1842,625,1217
202003,11545,서울특별시,금천구,85-89세,1871,632,1239
202004,11545,서울특별시,금천구,85-89세,1900,641,1259
202005,11545,서울특별시,금천구,85-89세,1920,646,1274
202006,11545,서울특별시,금천구,85-89세,1928,651,1277
202001,11545,서울특별시,금천구,90-94세,601,131,470
202002,11545,서울특별시,금천구,90-94세,612,138,474
202003,11545,서울특별시,금천구,90-94세,625,141,484
202004,11545,서울특별시,금천구,90-94세,622,142,480
202005,11545,서울특별시,금천구,90-94세,622,147,475
202006,11545,서울특별시,금천구,90-94세,629,148,481
202001,11545,서울특별시,금천구,95-99세,171,54,117
202002,11545,서울특별시,금천구,95-99세,173,55,118
202003,11545,서울특별시,금천구,95-99세,180,56,124
202004,11545,서울특별시,금천구,95-99세,185,58,127
202005,11545,서울특별시,금천구,95-99세,188,57,131
202006,11545,서울특별시,금천구,95-99세,186,57,129
202001,11545,서울특별시,금천구,100+,169,56,113
202002,11545,서울특별시,금천구,100+,170,56,114
202003,11545,서울특별시,금천구,100+,169,56,113
202004,11545,서울특별시,금천구,100+,170,56,114
202005,11545,서울특별시,금천구,100+,171,57,114
202006,11545,서울특별시,금천구,100+,173,57,116
202001,11560,서울특별시,영등포구,0-4세,12731,6484,6247
202002,11560,서울특별시,영등포구,0-4세,12827,6531,6296
202003,11560,서울특별시,영등포구,0-4세,12909,6577,6332
202004,11560,서울특별시,영등포구,0-4세,12833,6552,6281
202005,11560,서울특별시,영등포구,0-4세,12766,6506,6260
202006,11560,서울특별시,영등포구,0-4세,12739,6460,6279
202001,11560,서울특별시,영등포구,5-9세,12572,6355,6217
202002,11560,서울특별시,영등포구,5-9세,12624,6374,6250
202003,11560,서울특별시,영등포구,5-9세,12723,6432,6291
202004,11560,서울특별시,영등포구,5-9세,12724,6440,6284
202005,11560,서울특별시,영등포구,5-9세,12740,6462,6278
202006,11560,서울특별시,영등포구,5-9세,12767,6510,6257
202001,11560,서울특별시,영등포구,10-14세,11218,5871,5347
202002,11560,서울특별시,영등포구,10-14세,11228,5890,5338
202003,11560,서울특별시,영등포구,10-14세,11224,5867,5357
202004,11560,서울특별시,영등포구,10-14세,11214,5854,5360
202005,11560,서울특별시,영등포구,10-14세,11245,5852,5393
202006,11560,서울특별시,영등포구,10-14세,11266,5856,5410
202001,11560,서울특별시,영등포구,15-19세,13504,7136,6368
202002,11560,서울특별시,영등포구,15-19세,13513,7114,6399
202003,11560,서울특별시,영등포구,15-19세,13490,7085,6405
202004,11560,서울특별시,영등포구,15-19세,13376,7013,6363
202005,11560,서울특별시,영등포구,15-19세,13281,6969,6312
202006,11560,서울특별시,영등포구,15-19세,13243,6931,6312
202001,11560,서울특별시,영등포구,20-24세,21783,10235,11548
202002,11560,서울특별시,영등포구,20-24세,21904,10254,11650
202003,11560,서울특별시,영등포구,20-24세,22058,10302,11756
202004,11560,서울특별시,영등포구,20-24세,22031,10302,11729
202005,11560,서울특별시,영등포구,20-24세,22021,10274,11747
202006,11560,서울특별시,영등포구,20-24세,22027,10248,11779
202001,11560,서울특별시,영등포구,25-29세,35006,16730,18276
202002,11560,서울특별시,영등포구,25-29세,35249,16818,18431
202003,11560,서울특별시,영등포구,25-29세,35716,17017,18699
202004,11560,서울특별시,영등포구,25-29세,35836,17029,18807
202005,11560,서울특별시,영등포구,25-29세,35923,17052,18871
202006,11560,서울특별시,영등포구,25-29세,36058,17134,18924
202001,11560,서울특별시,영등포구,30-34세,33662,17132,16530
202002,11560,서울특별시,영등포구,30-34세,33998,17315,16683
202003,11560,서울특별시,영등포구,30-34세,34215,17415,16800
202004,11560,서울특별시,영등포구,30-34세,34387,17518,16869
202005,11560,서울특별시,영등포구,30-34세,34508,17554,16954
202006,11560,서울특별시,영등포구,30-34세,34694,17607,17087
202001,11560,서울특별시,영등포구,35-39세,32269,16840,15429
202002,11560,서울특별시,영등포구,35-39세,32438,16923,15515
202003,11560,서울특별시,영등포구,35-39세,32648,17081,15567
202004,11560,서울특별시,영등포구,35-39세,32669,17065,15604
202005,11560,서울특별시,영등포구,35-39세,32712,17091,15621
202006,11560,서울특별시,영등포구,35-39세,32793,17167,15626
202001,11560,서울특별시,영등포구,40-44세,26732,13687,13045
202002,11560,서울특별시,영등포구,40-44세,27000,13817,13183
202003,11560,서울특별시,영등포구,40-44세,26944,13787,13157
202004,11560,서울특별시,영등포구,40-44세,26915,13782,13133
202005,11560,서울특별시,영등포구,40-44세,26909,13812,13097
202006,11560,서울특별시,영등포구,40-44세,26970,13840,13130
202001,11560,서울특별시,영등포구,45-49세,28875,14890,13985
202002,11560,서울특별시,영등포구,45-49세,28973,14914,14059
202003,11560,서울특별시,영등포구,45-49세,28979,14925,14054
202004,11560,서울특별시,영등포구,45-49세,28993,14952,14041
202005,11560,서울특별시,영등포구,45-49세,28905,14882,14023
202006,11560,서울특별시,영등포구,45-49세,28885,14847,14038
202001,11560,서울특별시,영등포구,50-54세,27754,14158,13596
202002,11560,서울특별시,영등포구,50-54세,27970,14233,13737
202003,11560,서울특별시,영등포구,50-54세,28041,14263,13778
202004,11560,서울특별시,영등포구,50-54세,28049,14261,13788
202005,11560,서울특별시,영등포구,50-54세,28099,14277,13822
202006,11560,서울특별시,영등포구,50-54세,28209,14357,13852
202001,11560,서울특별시,영등포구,55-59세,28377,14337,14040
202002,11560,서울특별시,영등포구,55-59세,28452,14420,14032
202003,11560,서울특별시,영등포구,55-59세,28483,14465,14018
202004,11560,서울특별시,영등포구,55-59세,28420,14431,13989
202005,11560,서울특별시,영등포구,55-59세,28379,14416,13963
202006,11560,서울특별시,영등포구,55-59세,28216,14360,13856
202001,11560,서울특별시,영등포구,60-64세,26121,12835,13286
202002,11560,서울특별시,영등포구,60-64세,26210,12875,13335
202003,11560,서울특별시,영등포구,60-64세,26207,12877,13330
202004,11560,서울특별시,영등포구,60-64세,26304,12957,13347
202005,11560,서울특별시,영등포구,60-64세,26359,12990,13369
202006,11560,서울특별시,영등포구,60-64세,26506,13057,13449
202001,11560,서울특별시,영등포구,65-69세,18543,8841,9702
202002,11560,서울특별시,영등포구,65-69세,18708,8921,9787
202003,11560,서울특별시,영등포구,65-69세,19051,9084,9967
202004,11560,서울특별시,영등포구,65-69세,19137,9122,10015
202005,11560,서울특별시,영등포구,65-69세,19208,9166,10042
202006,11560,서울특별시,영등포구,65-69세,19329,9237,10092
202001,11560,서울특별시,영등포구,70-74세,14953,7086,7867
202002,11560,서울특별시,영등포구,70-74세,15057,7131,7926
202003,11560,서울특별시,영등포구,70-74세,15118,7153,7965
202004,11560,서울특별시,영등포구,70-74세,15127,7133,7994
202005,11560,서울특별시,영등포구,70-74세,15169,7129,8040
202006,11560,서울특별시,영등포구,70-74세,15217,7134,8083
202001,11560,서울특별시,영등포구,75-79세,11441,5135,6306
202002,11560,서울특별시,영등포구,75-79세,11436,5126,6310
202003,11560,서울특별시,영등포구,75-79세,11478,5129,6349
202004,11560,서울특별시,영등포구,75-79세,11529,5158,6371
202005,11560,서울특별시,영등포구,75-79세,11602,5211,6391
202006,11560,서울특별시,영등포구,75-79세,11652,5244,6408
202001,11560,서울특별시,영등포구,80-84세,7352,3153,4199
202002,11560,서울특별시,영등포구,80-84세,7431,3185,4246
202003,11560,서울특별시,영등포구,80-84세,7443,3188,4255
202004,11560,서울특별시,영등포구,80-84세,7447,3185,4262
202005,11560,서울특별시,영등포구,80-84세,7432,3169,4263
202006,11560,서울특별시,영등포구,80-84세,7464,3184,4280
202001,11560,서울특별시,영등포구,85-89세,3271,1120,2151
202002,11560,서울특별시,영등포구,85-89세,3322,1145,2177
202003,11560,서울특별시,영등포구,85-89세,3404,1184,2220
202004,11560,서울특별시,영등포구,85-89세,3449,1201,2248
202005,11560,서울특별시,영등포구,85-89세,3503,1228,2275
202006,11560,서울특별시,영등포구,85-89세,3522,1240,2282
202001,11560,서울특별시,영등포구,90-94세,1141,314,827
202002,11560,서울특별시,영등포구,90-94세,1156,319,837
202003,11560,서울특별시,영등포구,90-94세,1151,318,833
202004,11560,서울특별시,영등포구,90-94세,1157,321,836
202005,11560,서울특별시,영등포구,90-94세,1173,323,850
202006,11560,서울특별시,영등포구,90-94세,1160,319,841
202001,11560,서울특별시,영등포구,95-99세,340,98,242
202002,11560,서울특별시,영등포구,95-99세,339,94,245
202003,11560,서울특별시,영등포구,95-99세,350,100,250
202004,11560,서울특별시,영등포구,95-99세,354,103,251
202005,11560,서울특별시,영등포구,95-99세,360,105,255
202006,11560,서울특별시,영등포구,95-99세,360,106,254
202001,11560,서울특별시,영등포구,100+,271,67,204
202002,11560,서울특별시,영등포구,100+,273,69,204
202003,11560,서울특별시,영등포구,100+,271,67,204
202004,11560,서울특별시,영등포구,100+,274,67,207
202005,11560,서울특별시,영등포구,100+,274,67,207
202006,11560,서울특별시,영등포구,100+,272,67,205
202001,11590,서울특별시,동작구,0-4세,12347,6272,6075
202002,11590,서울특별시,동작구,0-4세,12205,6219,5986
202003,11590,서울특별시,동작구,0-4세,12074,6147,5927
202004,11590,서울특별시,동작구,0-4세,11972,6103,5869
202005,11590,서울특별시,동작구,0-4세,11877,6046,5831
202006,11590,서울특별시,동작구,0-4세,11766,5999,5767
202001,11590,서울특별시,동작구,5-9세,14098,7229,6869
202002,11590,서울특별시,동작구,5-9세,13965,7181,6784
202003,11590,서울특별시,동작구,5-9세,13965,7185,6780
202004,11590,서울특별시,동작구,5-9세,13945,7145,6800
202005,11590,서울특별시,동작구,5-9세,13975,7164,6811
202006,11590,서울특별시,동작구,5-9세,13977,7143,6834
202001,11590,서울특별시,동작구,10-14세,13209,6781,6428
202002,11590,서울특별시,동작구,10-14세,13117,6708,6409
202003,11590,서울특별시,동작구,10-14세,13077,6712,6365
202004,11590,서울특별시,동작구,10-14세,13112,6739,6373
202005,11590,서울특별시,동작구,10-14세,13088,6742,6346
202006,11590,서울특별시,동작구,10-14세,13103,6774,6329
202001,11590,서울특별시,동작구,15-19세,16044,8201,7843
202002,11590,서울특별시,동작구,15-19세,16068,8192,7876
202003,11590,서울특별시,동작구,15-19세,16030,8154,7876
202004,11590,서울특별시,동작구,15-19세,15900,8095,7805
202005,11590,서울특별시,동작구,15-19세,15772,8045,7727
202006,11590,서울특별시,동작구,15-19세,15641,7960,7681
202001,11590,서울특별시,동작구,20-24세,28185,13336,14849
202002,11590,서울특별시,동작구,20-24세,28411,13400,15011
202003,11590,서울특별시,동작구,20-24세,28427,13379,15048
202004,11590,서울특별시,동작구,20-24세,28389,13340,15049
202005,11590,서울특별시,동작구,20-24세,28336,13280,15056
202006,11590,서울특별시,동작구,20-24세,28340,13242,15098
202001,11590,서울특별시,동작구,25-29세,38210,19071,19139
202002,11590,서울특별시,동작구,25-29세,37928,18893,19035
202003,11590,서울특별시,동작구,25-29세,38198,18970,19228
202004,11590,서울특별시,동작구,25-29세,38305,18982,19323
202005,11590,서울특별시,동작구,25-29세,38495,19061,19434
202006,11590,서울특별시,동작구,25-29세,38654,19162,19492
202001,11590,서울특별시,동작구,30-34세,31984,16179,15805
202002,11590,서울특별시,동작구,30-34세,32028,16197,15831
202003,11590,서울특별시,동작구,30-34세,31904,16116,15788
202004,11590,서울특별시,동작구,30-34세,31933,16141,15792
202005,11590,서울특별시,동작구,30-34세,32005,16177,15828
202006,11590,서울특별시,동작구,30-34세,32059,16209,15850
202001,11590,서울특별시,동작구,35-39세,31903,16119,15784
202002,11590,서울특별시,동작구,35-39세,31598,15977,15621
202003,11590,서울특별시,동작구,35-39세,31495,15952,15543
202004,11590,서울특별시,동작구,35-39세,31389,15898,15491
202005,11590,서울특별시,동작구,35-39세,31359,15890,15469
202006,11590,서울특별시,동작구,35-39세,31238,15822,15416
202001,11590,서울특별시,동작구,40-44세,28980,14505,14475
202002,11590,서울특별시,동작구,40-44세,29013,14524,14489
202003,11590,서울특별시,동작구,40-44세,28858,14454,14404
202004,11590,서울특별시,동작구,40-44세,28782,14417,14365
202005,11590,서울특별시,동작구,40-44세,28810,14432,14378
202006,11590,서울특별시,동작구,40-44세,28840,14455,14385
202001,11590,서울특별시,동작구,45-49세,31465,15778,15687
202002,11590,서울특별시,동작구,45-49세,31394,15713,15681
202003,11590,서울특별시,동작구,45-49세,31320,15638,15682
202004,11590,서울특별시,동작구,45-49세,31336,15662,15674
202005,11590,서울특별시,동작구,45-49세,31203,15618,15585
202006,11590,서울특별시,동작구,45-49세,31114,15575,15539
202001,11590,서울특별시,동작구,50-54세,29464,14179,15285
202002,11590,서울특별시,동작구,50-54세,29521,14193,15328
202003,11590,서울특별시,동작구,50-54세,29485,14229,15256
202004,11590,서울특별시,동작구,50-54세,29497,14237,15260
202005,11590,서울특별시,동작구,50-54세,29602,14307,15295
202006,11590,서울특별시,동작구,50-54세,29594,14275,15319
202001,11590,서울특별시,동작구,55-59세,29735,14144,15591
202002,11590,서울특별시,동작구,55-59세,29649,14133,15516
202003,11590,서울특별시,동작구,55-59세,29517,14041,15476
202004,11590,서울특별시,동작구,55-59세,29479,14045,15434
202005,11590,서울특별시,동작구,55-59세,29418,14012,15406
202006,11590,서울특별시,동작구,55-59세,29292,13980,15312
202001,11590,서울특별시,동작구,60-64세,27657,12843,14814
202002,11590,서울특별시,동작구,60-64세,27672,12845,14827
202003,11590,서울특별시,동작구,60-64세,27574,12830,14744
202004,11590,서울특별시,동작구,60-64세,27631,12862,14769
202005,11590,서울특별시,동작구,60-64세,27661,12850,14811
202006,11590,서울특별시,동작구,60-64세,27780,12896,14884
202001,11590,서울특별시,동작구,65-69세,19983,9098,10885
202002,11590,서울특별시,동작구,65-69세,20113,9141,10972
202003,11590,서울특별시,동작구,65-69세,20360,9248,11112
202004,11590,서울특별시,동작구,65-69세,20453,9285,11168
202005,11590,서울특별시,동작구,65-69세,20554,9323,11231
202006,11590,서울특별시,동작구,65-69세,20616,9344,11272
202001,11590,서울특별시,동작구,70-74세,16540,7264,9276
202002,11590,서울특별시,동작구,70-74세,16591,7301,9290
202003,11590,서울특별시,동작구,70-74세,16672,7339,9333
202004,11590,서울특별시,동작구,70-74세,16682,7330,9352
202005,11590,서울특별시,동작구,70-74세,16689,7350,9339
202006,11590,서울특별시,동작구,70-74세,16696,7352,9344
202001,11590,서울특별시,동작구,75-79세,12666,5866,6800
202002,11590,서울특별시,동작구,75-79세,12647,5849,6798
202003,11590,서울특별시,동작구,75-79세,12667,5857,6810
202004,11590,서울특별시,동작구,75-79세,12706,5882,6824
202005,11590,서울특별시,동작구,75-79세,12782,5907,6875
202006,11590,서울특별시,동작구,75-79세,12844,5921,6923
202001,11590,서울특별시,동작구,80-84세,7708,3185,4523
202002,11590,서울특별시,동작구,80-84세,7764,3218,4546
202003,11590,서울특별시,동작구,80-84세,7844,3258,4586
202004,11590,서울특별시,동작구,80-84세,7895,3275,4620
202005,11590,서울특별시,동작구,80-84세,7942,3303,4639
202006,11590,서울특별시,동작구,80-84세,7962,3315,4647
202001,11590,서울특별시,동작구,85-89세,3471,1179,2292
202002,11590,서울특별시,동작구,85-89세,3515,1200,2315
202003,11590,서울특별시,동작구,85-89세,3528,1209,2319
202004,11590,서울특별시,동작구,85-89세,3554,1218,2336
202005,11590,서울특별시,동작구,85-89세,3572,1225,2347
202006,11590,서울특별시,동작구,85-89세,3594,1239,2355
202001,11590,서울특별시,동작구,90-94세,1322,357,965
202002,11590,서울특별시,동작구,90-94세,1334,361,973
202003,11590,서울특별시,동작구,90-94세,1349,364,985
202004,11590,서울특별시,동작구,90-94세,1360,363,997
202005,11590,서울특별시,동작구,90-94세,1363,363,1000
202006,11590,서울특별시,동작구,90-94세,1375,360,1015
202001,11590,서울특별시,동작구,95-99세,370,99,271
202002,11590,서울특별시,동작구,95-99세,367,98,269
202003,11590,서울특별시,동작구,95-99세,368,100,268
202004,11590,서울특별시,동작구,95-99세,365,99,266
202005,11590,서울특별시,동작구,95-99세,371,96,275
202006,11590,서울특별시,동작구,95-99세,372,97,275
202001,11590,서울특별시,동작구,100+,295,87,208
202002,11590,서울특별시,동작구,100+,301,90,211
202003,11590,서울특별시,동작구,100+,302,90,212
202004,11590,서울특별시,동작구,100+,303,89,214
202005,11590,서울특별시,동작구,100+,306,90,216
202006,11590,서울특별시,동작구,100+,308,91,217
202001,11620,서울특별시,관악구,0-4세,11573,5997,5576
202002,11620,서울특별시,관악구,0-4세,11379,5892,5487
202003,11620,서울특별시,관악구,0-4세,11205,5794,5411
202004,11620,서울특별시,관악구,0-4세,11021,5688,5333
202005,11620,서울특별시,관악구,0-4세,10908,5626,5282
202006,11620,서울특별시,관악구,0-4세,10791,5570,5221
202001,11620,서울특별시,관악구,5-9세,13231,6779,6452
202002,11620,서울특별시,관악구,5-9세,13083,6696,6387
202003,11620,서울특별시,관악구,5-9세,13043,6682,6361
202004,11620,서울특별시,관악구,5-9세,12973,6653,6320
202005,11620,서울특별시,관악구,5-9세,12961,6634,6327
202006,11620,서울특별시,관악구,5-9세,12947,6636,6311
202001,11620,서울특별시,관악구,10-14세,13238,6800,6438
202002,11620,서울특별시,관악구,10-14세,13162,6792,6370
202003,11620,서울특별시,관악구,10-14세,13104,6759,6345
202004,11620,서울특별시,관악구,10-14세,13081,6745,6336
202005,11620,서울특별시,관악구,10-14세,13016,6708,6308
202006,11620,서울특별시,관악구,10-14세,12978,6680,6298
202001,11620,서울특별시,관악구,15-19세,17256,8903,8353
202002,11620,서울특별시,관악구,15-19세,17260,8864,8396
202003,11620,서울특별시,관악구,15-19세,17230,8845,8385
202004,11620,서울특별시,관악구,15-19세,17126,8778,8348
202005,11620,서울특별시,관악구,15-19세,16994,8680,8314
202006,11620,서울특별시,관악구,15-19세,16863,8595,8268
202001,11620,서울특별시,관악구,20-24세,39891,17688,22203
202002,11620,서울특별시,관악구,20-24세,40108,17742,22366
202003,11620,서울특별시,관악구,20-24세,40240,17784,22456
202004,11620,서울특별시,관악구,20-24세,40230,17750,22480
202005,11620,서울특별시,관악구,20-24세,40409,17853,22556
202006,11620,서울특별시,관악구,20-24세,40519,17940,22579
202001,11620,서울특별시,관악구,25-29세,67758,35010,32748
202002,11620,서울특별시,관악구,25-29세,67649,35019,32630
202003,11620,서울특별시,관악구,25-29세,68103,35221,32882
202004,11620,서울특별시,관악구,25-29세,68285,35278,33007
202005,11620,서울특별시,관악구,25-29세,68645,35422,33223
202006,11620,서울특별시,관악구,25-29세,69183,35670,33513
202001,11620,서울특별시,관악구,30-34세,48316,26666,21650
202002,11620,서울특별시,관악구,30-34세,48535,26789,21746
202003,11620,서울특별시,관악구,30-34세,48473,26814,21659
202004,11620,서울특별시,관악구,30-34세,48513,26861,21652
202005,11620,서울특별시,관악구,30-34세,48740,27023,21717
202006,11620,서울특별시,관악구,30-34세,48908,27135,21773
202001,11620,서울특별시,관악구,35-39세,40311,22006,18305
202002,11620,서울특별시,관악구,35-39세,39983,21850,18133
202003,11620,서울특별시,관악구,35-39세,39752,21746,18006
202004,11620,서울특별시,관악구,35-39세,39523,21612,17911
202005,11620,서울특별시,관악구,35-39세,39427,21556,17871
202006,11620,서울특별시,관악구,35-39세,39292,21478,17814
202001,11620,서울특별시,관악구,40-44세,33664,18051,15613
202002,11620,서울특별시,관악구,40-44세,33619,18020,15599
202003,11620,서울특별시,관악구,40-44세,33466,17934,15532
202004,11620,서울특별시,관악구,40-44세,33419,17926,15493
202005,11620,서울특별시,관악구,40-44세,33373,17902,15471
202006,11620,서울특별시,관악구,40-44세,33397,17930,15467
202001,11620,서울특별시,관악구,45-49세,37112,19626,17486
202002,11620,서울특별시,관악구,45-49세,36998,19576,17422
202003,11620,서울특별시,관악구,45-49세,36794,19492,17302
202004,11620,서울특별시,관악구,45-49세,36652,19394,17258
202005,11620,서울특별시,관악구,45-49세,36538,19326,17212
202006,11620,서울특별시,관악구,45-49세,36380,19262,17118
202001,11620,서울특별시,관악구,50-54세,34593,17423,17170
202002,11620,서울특별시,관악구,50-54세,34555,17423,17132
202003,11620,서울특별시,관악구,50-54세,34471,17412,17059
202004,11620,서울특별시,관악구,50-54세,34493,17439,17054
202005,11620,서울특별시,관악구,50-54세,34535,17488,17047
202006,11620,서울특별시,관악구,50-54세,34531,17463,17068
202001,11620,서울특별시,관악구,55-59세,34884,17049,17835
202002,11620,서울특별시,관악구,55-59세,34815,17015,17800
202003,11620,서울특별시,관악구,55-59세,34646,16942,17704
202004,11620,서울특별시,관악구,55-59세,34594,16931,17663
202005,11620,서울특별시,관악구,55-59세,34493,16901,17592
202006,11620,서울특별시,관악구,55-59세,34232,16797,17435
202001,11620,서울특별시,관악구,60-64세,32852,15382,17470
202002,11620,서울특별시,관악구,60-64세,32882,15439,17443
202003,11620,서울특별시,관악구,60-64세,32673,15333,17340
202004,11620,서울특별시,관악구,60-64세,32677,15318,17359
202005,11620,서울특별시,관악구,60-64세,32690,15297,17393
202006,11620,서울특별시,관악구,60-64세,32863,15415,17448
202001,11620,서울특별시,관악구,65-69세,24805,11408,13397
202002,11620,서울특별시,관악구,65-69세,24956,11477,13479
202003,11620,서울특별시,관악구,65-69세,25342,11668,13674
202004,11620,서울특별시,관악구,65-69세,25362,11669,13693
202005,11620,서울특별시,관악구,65-69세,25433,11709,13724
202006,11620,서울특별시,관악구,65-69세,25455,11693,13762
202001,11620,서울특별시,관악구,70-74세,20546,9394,11152
202002,11620,서울특별시,관악구,70-74세,20610,9425,11185
202003,11620,서울특별시,관악구,70-74세,20680,9445,11235
202004,11620,서울특별시,관악구,70-74세,20723,9465,11258
202005,11620,서울특별시,관악구,70-74세,20754,9481,11273
202006,11620,서울특별시,관악구,70-74세,20754,9485,11269
202001,11620,서울특별시,관악구,75-79세,15802,7336,8466
202002,11620,서울특별시,관악구,75-79세,15811,7314,8497
202003,11620,서울특별시,관악구,75-79세,15801,7306,8495
202004,11620,서울특별시,관악구,75-79세,15873,7344,8529
202005,11620,서울특별시,관악구,75-79세,15998,7401,8597
202006,11620,서울특별시,관악구,75-79세,16095,7437,8658
202001,11620,서울특별시,관악구,80-84세,8664,3745,4919
202002,11620,서울특별시,관악구,80-84세,8749,3806,4943
202003,11620,서울특별시,관악구,80-84세,8816,3844,4972
202004,11620,서울특별시,관악구,80-84세,8867,3870,4997
202005,11620,서울특별시,관악구,80-84세,8884,3873,5011
202006,11620,서울특별시,관악구,80-84세,8905,3887,5018
202001,11620,서울특별시,관악구,85-89세,3476,1216,2260
202002,11620,서울특별시,관악구,85-89세,3523,1228,2295
202003,11620,서울특별시,관악구,85-89세,3595,1265,2330
202004,11620,서울특별시,관악구,85-89세,3603,1263,2340
202005,11620,서울특별시,관악구,85-89세,3656,1284,2372
202006,11620,서울특별시,관악구,85-89세,3666,1289,2377
202001,11620,서울특별시,관악구,90-94세,1249,303,946
202002,11620,서울특별시,관악구,90-94세,1261,308,953
202003,11620,서울특별시,관악구,90-94세,1283,309,974
202004,11620,서울특별시,관악구,90-94세,1299,310,989
202005,11620,서울특별시,관악구,90-94세,1306,314,992
202006,11620,서울특별시,관악구,90-94세,1314,319,995
202001,11620,서울특별시,관악구,95-99세,339,86,253
202002,11620,서울특별시,관악구,95-99세,339,83,256
202003,11620,서울특별시,관악구,95-99세,348,84,264
202004,11620,서울특별시,관악구,95-99세,353,81,272
202005,11620,서울특별시,관악구,95-99세,357,83,274
202006,11620,서울특별시,관악구,95-99세,351,79,272
202001,11620,서울특별시,관악구,100+,309,63,246
202002,11620,서울특별시,관악구,100+,310,64,246
202003,11620,서울특별시,관악구,100+,309,64,245
202004,11620,서울특별시,관악구,100+,311,67,244
202005,11620,서울특별시,관악구,100+,314,67,247
202006,11620,서울특별시,관악구,100+,316,69,247
202001,11650,서울특별시,서초구,0-4세,14592,7532,7060
202002,11650,서울특별시,서초구,0-4세,14547,7522,7025
202003,11650,서울특별시,서초구,0-4세,14339,7418,6921
202004,11650,서울특별시,서초구,0-4세,14198,7341,6857
202005,11650,서울특별시,서초구,0-4세,13995,7244,6751
202006,11650,서울특별시,서초구,0-4세,13871,7170,6701
202001,11650,서울특별시,서초구,5-9세,21311,11031,10280
202002,11650,서울특별시,서초구,5-9세,21405,11051,10354
202003,11650,서울특별시,서초구,5-9세,21323,11015,10308
202004,11650,서울특별시,서초구,5-9세,21180,10962,10218
202005,11650,서울특별시,서초구,5-9세,21179,10973,10206
202006,11650,서울특별시,서초구,5-9세,21116,10941,10175
202001,11650,서울특별시,서초구,10-14세,22405,11415,10990
202002,11650,서울특별시,서초구,10-14세,22463,11441,11022
202003,11650,서울특별시,서초구,10-14세,22459,11424,11035
202004,11650,서울특별시,서초구,10-14세,22502,11429,11073
202005,11650,서울특별시,서초구,10-14세,22535,11420,11115
202006,11650,서울특별시,서초구,10-14세,22619,11466,11153
202001,11650,서울특별시,서초구,15-19세,23487,11963,11524
202002,11650,서울특별시,서초구,15-19세,23362,11939,11423
202003,11650,서울특별시,서초구,15-19세,23202,11853,11349
202004,11650,서울특별시,서초구,15-19세,23120,11835,11285
202005,11650,서울특별시,서초구,15-19세,22944,11746,11198
202006,11650,서울특별시,서초구,15-19세,22766,11649,11117
202001,11650,서울특별시,서초구,20-24세,25658,12600,13058
202002,11650,서울특별시,서초구,20-24세,25601,12552,13049
202003,11650,서울특별시,서초구,20-24세,25529,12479,13050
202004,11650,서울특별시,서초구,20-24세,25502,12447,13055
202005,11650,서울특별시,서초구,20-24세,25509,12446,13063
202006,11650,서울특별시,서초구,20-24세,25504,12456,13048
202001,11650,서울특별시,서초구,25-29세,30860,14640,16220
202002,11650,서울특별시,서초구,25-29세,30680,14586,16094
202003,11650,서울특별시,서초구,25-29세,30803,14658,16145
202004,11650,서울특별시,서초구,25-29세,30714,14601,16113
202005,11650,서울특별시,서초구,25-29세,30723,14599,16124
202006,11650,서울특별시,서초구,25-29세,30647,14530,16117
202001,11650,서울특별시,서초구,30-34세,30770,14148,16622
202002,11650,서울특별시,서초구,30-34세,30713,14101,16612
202003,11650,서울특별시,서초구,30-34세,30667,14086,16581
202004,11650,서울특별시,서초구,30-34세,30547,14057,16490
202005,11650,서울특별시,서초구,30-34세,30482,14043,16439
202006,11650,서울특별시,서초구,30-34세,30414,14019,16395
202001,11650,서울특별시,서초구,35-39세,35762,16315,19447
202002,11650,서울특별시,서초구,35-39세,35735,16333,19402
202003,11650,서울특별시,서초구,35-39세,35497,16231,19266
202004,11650,서울특별시,서초구,35-39세,35261,16129,19132
202005,11650,서울특별시,서초구,35-39세,35059,16041,19018
202006,11650,서울특별시,서초구,35-39세,34896,15995,18901
202001,11650,서울특별시,서초구,40-44세,37046,17119,19927
202002,11650,서울특별시,서초구,40-44세,37278,17149,20129
202003,11650,서울특별시,서초구,40-44세,37082,17039,20043
202004,11650,서울특별시,서초구,40-44세,37066,17034,20032
202005,11650,서울특별시,서초구,40-44세,37004,16964,20040
202006,11650,서울특별시,서초구,40-44세,37008,16943,20065
202001,11650,서울특별시,서초구,45-49세,41690,20050,21640
202002,11650,서울특별시,서초구,45-49세,41647,20046,21601
202003,11650,서울특별시,서초구,45-49세,41503,19996,21507
202004,11650,서울특별시,서초구,45-49세,41399,19956,21443
202005,11650,서울특별시,서초구,45-49세,41282,19933,21349
202006,11650,서울특별시,서초구,45-49세,41137,19846,21291
202001,11650,서울특별시,서초구,50-54세,33618,16695,16923
202002,11650,서울특별시,서초구,50-54세,33738,16742,16996
202003,11650,서울특별시,서초구,50-54세,33790,16751,17039
202004,11650,서울특별시,서초구,50-54세,33832,16797,17035
202005,11650,서울특별시,서초구,50-54세,34017,16897,17120
202006,11650,서울특별시,서초구,50-54세,34141,16977,17164
202001,11650,서울특별시,서초구,55-59세,29256,14080,15176
202002,11650,서울특별시,서초구,55-59세,29261,14092,15169
202003,11650,서울특별시,서초구,55-59세,29170,14079,15091
202004,11650,서울특별시,서초구,55-59세,29075,14010,15065
202005,11650,서울특별시,서초구,55-59세,29076,13988,15088
202006,11650,서울특별시,서초구,55-59세,28916,13926,14990
202001,11650,서울특별시,서초구,60-64세,27220,12561,14659
202002,11650,서울특별시,서초구,60-64세,27165,12544,14621
202003,11650,서울특별시,서초구,60-64세,26978,12476,14502
202004,11650,서울특별시,서초구,60-64세,26906,12479,14427
202005,11650,서울특별시,서초구,60-64세,26842,12472,14370
202006,11650,서울특별시,서초구,60-64세,26926,12514,14412
202001,11650,서울특별시,서초구,65-69세,19447,8907,10540
202002,11650,서울특별시,서초구,65-69세,19605,8958,10647
202003,11650,서울특별시,서초구,65-69세,19935,9079,10856
202004,11650,서울특별시,서초구,65-69세,20020,9122,10898
202005,11650,서울특별시,서초구,65-69세,20178,9196,10982
202006,11650,서울특별시,서초구,65-69세,20261,9217,11044
202001,11650,서울특별시,서초구,70-74세,15976,7364,8612
202002,11650,서울특별시,서초구,70-74세,16055,7396,8659
202003,11650,서울특별시,서초구,70-74세,16101,7402,8699
202004,11650,서울특별시,서초구,70-74세,16110,7391,8719
202005,11650,서울특별시,서초구,70-74세,16116,7379,8737
202006,11650,서울특별시,서초구,70-74세,16183,7409,8774
202001,11650,서울특별시,서초구,75-79세,10681,5241,5440
202002,11650,서울특별시,서초구,75-79세,10711,5242,5469
202003,11650,서울특별시,서초구,75-79세,10740,5262,5478
202004,11650,서울특별시,서초구,75-79세,10805,5303,5502
202005,11650,서울특별시,서초구,75-79세,10877,5328,5549
202006,11650,서울특별시,서초구,75-79세,10960,5358,5602
202001,11650,서울특별시,서초구,80-84세,6260,2841,3419
202002,11650,서울특별시,서초구,80-84세,6299,2864,3435
202003,11650,서울특별시,서초구,80-84세,6332,2880,3452
202004,11650,서울특별시,서초구,80-84세,6334,2883,3451
202005,11650,서울특별시,서초구,80-84세,6354,2908,3446
202006,11650,서울특별시,서초구,80-84세,6366,2937,3429
202001,11650,서울특별시,서초구,85-89세,3018,1086,1932
202002,11650,서울특별시,서초구,85-89세,3072,1105,1967
202003,11650,서울특별시,서초구,85-89세,3113,1129,1984
202004,11650,서울특별시,서초구,85-89세,3153,1146,2007
202005,11650,서울특별시,서초구,85-89세,3161,1157,2004
202006,11650,서울특별시,서초구,85-89세,3160,1153,2007
202001,11650,서울특별시,서초구,90-94세,1374,364,1010
202002,11650,서울특별시,서초구,90-94세,1371,370,1001
202003,11650,서울특별시,서초구,90-94세,1374,370,1004
202004,11650,서울특별시,서초구,90-94세,1375,369,1006
202005,11650,서울특별시,서초구,90-94세,1371,368,1003
202006,11650,서울특별시,서초구,90-94세,1386,370,1016
202001,11650,서울특별시,서초구,95-99세,407,110,297
202002,11650,서울특별시,서초구,95-99세,413,110,303
202003,11650,서울특별시,서초구,95-99세,413,108,305
202004,11650,서울특별시,서초구,95-99세,414,108,306
202005,11650,서울특별시,서초구,95-99세,419,107,312
202006,11650,서울특별시,서초구,95-99세,423,105,318
202001,11650,서울특별시,서초구,100+,212,50,162
202002,11650,서울특별시,서초구,100+,215,50,165
202003,11650,서울특별시,서초구,100+,218,52,166
202004,11650,서울특별시,서초구,100+,216,53,163
202005,11650,서울특별시,서초구,100+,217,55,162
202006,11650,서울특별시,서초구,100+,219,56,163
202001,11680,서울특별시,강남구,0-4세,15187,7775,7412
202002,11680,서울특별시,강남구,0-4세,15151,7764,7387
202003,11680,서울특별시,강남구,0-4세,14909,7649,7260
202004,11680,서울특별시,강남구,0-4세,14691,7553,7138
202005,11680,서울특별시,강남구,0-4세,14547,7481,7066
202006,11680,서울특별시,강남구,0-4세,14398,7395,7003
202001,11680,서울특별시,강남구,5-9세,23547,12262,11285
202002,11680,서울특별시,강남구,5-9세,23828,12420,11408
202003,11680,서울특별시,강남구,5-9세,23679,12346,11333
202004,11680,서울특별시,강남구,5-9세,23595,12298,11297
202005,11680,서울특별시,강남구,5-9세,23476,12237,11239
202006,11680,서울특별시,강남구,5-9세,23366,12190,11176
202001,11680,서울특별시,강남구,10-14세,28283,14761,13522
202002,11680,서울특별시,강남구,10-14세,28530,14883,13647
202003,11680,서울특별시,강남구,10-14세,28488,14851,13637
202004,11680,서울특별시,강남구,10-14세,28417,14820,13597
202005,11680,서울특별시,강남구,10-14세,28450,14814,13636
202006,11680,서울특별시,강남구,10-14세,28530,14860,13670
202001,11680,서울특별시,강남구,15-19세,32118,16793,15325
202002,11680,서울특별시,강남구,15-19세,31724,16583,15141
202003,11680,서울특별시,강남구,15-19세,31525,16481,15044
202004,11680,서울특별시,강남구,15-19세,31237,16306,14931
202005,11680,서울특별시,강남구,15-19세,30985,16165,14820
202006,11680,서울특별시,강남구,15-19세,30815,16061,14754
202001,11680,서울특별시,강남구,20-24세,34107,16630,17477
202002,11680,서울특별시,강남구,20-24세,34001,16550,17451
202003,11680,서울특별시,강남구,20-24세,33828,16439,17389
202004,11680,서울특별시,강남구,20-24세,33785,16432,17353
202005,11680,서울특별시,강남구,20-24세,33696,16378,17318
202006,11680,서울특별시,강남구,20-24세,33634,16342,17292
202001,11680,서울특별시,강남구,25-29세,41764,19763,22001
202002,11680,서울특별시,강남구,25-29세,41502,19615,21887
202003,11680,서울특별시,강남구,25-29세,41603,19681,21922
202004,11680,서울특별시,강남구,25-29세,41480,19635,21845
202005,11680,서울특별시,강남구,25-29세,41478,19585,21893
202006,11680,서울특별시,강남구,25-29세,41458,19548,21910
202001,11680,서울특별시,강남구,30-34세,40270,18598,21672
202002,11680,서울특별시,강남구,30-34세,40284,18678,21606
202003,11680,서울특별시,강남구,30-34세,40212,18628,21584
202004,11680,서울특별시,강남구,30-34세,40205,18639,21566
202005,11680,서울특별시,강남구,30-34세,40097,18598,21499
202006,11680,서울특별시,강남구,30-34세,39968,18475,21493
202001,11680,서울특별시,강남구,35-39세,45213,20528,24685
202002,11680,서울특별시,강남구,35-39세,45150,20446,24704
202003,11680,서울특별시,강남구,35-39세,44801,20263,24538
202004,11680,서울특별시,강남구,35-39세,44480,20144,24336
202005,11680,서울특별시,강남구,35-39세,44164,19949,24215
202006,11680,서울특별시,강남구,35-39세,43903,19865,24038
202001,11680,서울특별시,강남구,40-44세,46745,21203,25542
202002,11680,서울특별시,강남구,40-44세,47331,21508,25823
202003,11680,서울특별시,강남구,40-44세,47065,21358,25707
202004,11680,서울특별시,강남구,40-44세,46857,21252,25605
202005,11680,서울특별시,강남구,40-44세,46732,21177,25555
202006,11680,서울특별시,강남구,40-44세,46679,21148,25531
202001,11680,서울특별시,강남구,45-49세,53646,25570,28076
202002,11680,서울특별시,강남구,45-49세,53525,25526,27999
202003,11680,서울특별시,강남구,45-49세,53302,25456,27846
202004,11680,서울특별시,강남구,45-49세,53095,25338,27757
202005,11680,서울특별시,강남구,45-49세,52956,25244,27712
202006,11680,서울특별시,강남구,45-49세,52856,25176,27680
202001,11680,서울특별시,강남구,50-54세,43893,22086,21807
202002,11680,서울특별시,강남구,50-54세,43958,22145,21813
202003,11680,서울특별시,강남구,50-54세,43924,22104,21820
202004,11680,서울특별시,강남구,50-54세,44063,22192,21871
202005,11680,서울특별시,강남구,50-54세,44059,22179,21880
202006,11680,서울특별시,강남구,50-54세,44193,22239,21954
202001,11680,서울특별시,강남구,55-59세,36508,17908,18600
202002,11680,서울특별시,강남구,55-59세,36343,17847,18496
202003,11680,서울특별시,강남구,55-59세,36130,17778,18352
202004,11680,서울특별시,강남구,55-59세,35965,17670,18295
202005,11680,서울특별시,강남구,55-59세,35961,17710,18251
202006,11680,서울특별시,강남구,55-59세,35794,17652,18142
202001,11680,서울특별시,강남구,60-64세,33177,15199,17978
202002,11680,서울특별시,강남구,60-64세,33165,15211,17954
202003,11680,서울특별시,강남구,60-64세,32877,15137,17740
202004,11680,서울특별시,강남구,60-64세,32801,15100,17701
202005,11680,서울특별시,강남구,60-64세,32644,15044,17600
202006,11680,서울특별시,강남구,60-64세,32681,15100,17581
202001,11680,서울특별시,강남구,65-69세,24828,11294,13534
202002,11680,서울특별시,강남구,65-69세,25047,11374,13673
202003,11680,서울특별시,강남구,65-69세,25406,11486,13920
202004,11680,서울특별시,강남구,65-69세,25464,11528,13936
202005,11680,서울특별시,강남구,65-69세,25516,11525,13991
202006,11680,서울특별시,강남구,65-69세,25609,11561,14048
202001,11680,서울특별시,강남구,70-74세,19889,9295,10594
202002,11680,서울특별시,강남구,70-74세,19984,9308,10676
202003,11680,서울특별시,강남구,70-74세,20058,9347,10711
202004,11680,서울특별시,강남구,70-74세,20073,9333,10740
202005,11680,서울특별시,강남구,70-74세,20056,9313,10743
202006,11680,서울특별시,강남구,70-74세,20109,9325,10784
202001,11680,서울특별시,강남구,75-79세,13147,6419,6728
202002,11680,서울특별시,강남구,75-79세,13193,6455,6738
202003,11680,서울특별시,강남구,75-79세,13215,6452,6763
202004,11680,서울특별시,강남구,75-79세,13235,6460,6775
202005,11680,서울특별시,강남구,75-79세,13305,6497,6808
202006,11680,서울특별시,강남구,75-79세,13398,6522,6876
202001,11680,서울특별시,강남구,80-84세,7408,3291,4117
202002,11680,서울특별시,강남구,80-84세,7482,3321,4161
202003,11680,서울특별시,강남구,80-84세,7501,3352,4149
202004,11680,서울특별시,강남구,80-84세,7499,3373,4126
202005,11680,서울특별시,강남구,80-84세,7515,3401,4114
202006,11680,서울특별시,강남구,80-84세,7545,3437,4108
202001,11680,서울특별시,강남구,85-89세,3737,1239,2498
202002,11680,서울특별시,강남구,85-89세,3752,1257,2495
202003,11680,서울특별시,강남구,85-89세,3788,1265,2523
202004,11680,서울특별시,강남구,85-89세,3813,1280,2533
202005,11680,서울특별시,강남구,85-89세,3810,1278,2532
202006,11680,서울특별시,강남구,85-89세,3817,1278,2539
202001,11680,서울특별시,강남구,90-94세,1715,413,1302
202002,11680,서울특별시,강남구,90-94세,1724,411,1313
202003,11680,서울특별시,강남구,90-94세,1720,416,1304
202004,11680,서울특별시,강남구,90-94세,1701,417,1284
202005,11680,서울특별시,강남구,90-94세,1695,418,1277
202006,11680,서울특별시,강남구,90-94세,1703,412,1291
202001,11680,서울특별시,강남구,95-99세,483,111,372
202002,11680,서울특별시,강남구,95-99세,489,113,376
202003,11680,서울특별시,강남구,95-99세,494,110,384
202004,11680,서울특별시,강남구,95-99세,500,110,390
202005,11680,서울특별시,강남구,95-99세,492,109,383
202006,11680,서울특별시,강남구,95-99세,494,111,383
202001,11680,서울특별시,강남구,100+,273,52,221
202002,11680,서울특별시,강남구,100+,273,51,222
202003,11680,서울특별시,강남구,100+,279,55,224
202004,11680,서울특별시,강남구,100+,284,56,228
202005,11680,서울특별시,강남구,100+,281,56,225
202006,11680,서울특별시,강남구,100+,283,56,227
202001,11710,서울특별시,송파구,0-4세,24363,12729,11634
202002,11710,서울특별시,송파구,0-4세,24178,12627,11551
202003,11710,서울특별시,송파구,0-4세,23845,12437,11408
202004,11710,서울특별시,송파구,0-4세,23580,12283,11297
202005,11710,서울특별시,송파구,0-4세,23332,12145,11187
202006,11710,서울특별시,송파구,0-4세,23170,12078,11092
202001,11710,서울특별시,송파구,5-9세,29093,14911,14182
202002,11710,서울특별시,송파구,5-9세,29167,14984,14183
202003,11710,서울특별시,송파구,5-9세,29025,14936,14089
202004,11710,서울특별시,송파구,5-9세,28974,14911,14063
202005,11710,서울특별시,송파구,5-9세,28933,14873,14060
202006,11710,서울특별시,송파구,5-9세,28918,14890,14028
202001,11710,서울특별시,송파구,10-14세,28735,14689,14046
202002,11710,서울특별시,송파구,10-14세,28625,14613,14012
202003,11710,서울특별시,송파구,10-14세,28614,14552,14062
202004,11710,서울특별시,송파구,10-14세,28625,14553,14072
202005,11710,서울특별시,송파구,10-14세,28640,14581,14059
202006,11710,서울특별시,송파구,10-14세,28691,14585,14106
202001,11710,서울특별시,송파구,15-19세,32776,16868,15908
202002,11710,서울특별시,송파구,15-19세,32477,16697,15780
202003,11710,서울특별시,송파구,15-19세,32105,16503,15602
202004,11710,서울특별시,송파구,15-19세,31803,16309,15494
202005,11710,서울특별시,송파구,15-19세,31497,16157,15340
202006,11710,서울특별시,송파구,15-19세,31338,16060,15278
202001,11710,서울특별시,송파구,20-24세,41659,20451,21208
202002,11710,서울특별시,송파구,20-24세,41537,20341,21196
202003,11710,서울특별시,송파구,20-24세,41414,20189,21225
202004,11710,서울특별시,송파구,20-24세,41326,20161,21165
202005,11710,서울특별시,송파구,20-24세,41260,20102,21158
202006,11710,서울특별시,송파구,20-24세,41101,20022,21079
202001,11710,서울특별시,송파구,25-29세,54192,25640,28552
202002,11710,서울특별시,송파구,25-29세,53888,25459,28429
202003,11710,서울특별시,송파구,25-29세,54152,25546,28606
202004,11710,서울특별시,송파구,25-29세,54122,25480,28642
202005,11710,서울특별시,송파구,25-29세,54065,25421,28644
202006,11710,서울특별시,송파구,25-29세,54027,25324,28703
202001,11710,서울특별시,송파구,30-34세,54803,26228,28575
202002,11710,서울특별시,송파구,30-34세,54855,26268,28587
202003,11710,서울특별시,송파구,30-34세,54671,26216,28455
202004,11710,서울특별시,송파구,30-34세,54657,26205,28452
202005,11710,서울특별시,송파구,30-34세,54662,26190,28472
202006,11710,서울특별시,송파구,30-34세,54593,26194,28399
202001,11710,서울특별시,송파구,35-39세,59712,28727,30985
202002,11710,서울특별시,송파구,35-39세,59637,28670,30967
202003,11710,서울특별시,송파구,35-39세,59093,28412,30681
202004,11710,서울특별시,송파구,35-39세,58786,28252,30534
202005,11710,서울특별시,송파구,35-39세,58565,28179,30386
202006,11710,서울특별시,송파구,35-39세,58305,28078,30227
202001,11710,서울특별시,송파구,40-44세,53417,25762,27655
202002,11710,서울특별시,송파구,40-44세,53617,25870,27747
202003,11710,서울특별시,송파구,40-44세,53501,25762,27739
202004,11710,서울특별시,송파구,40-44세,53386,25666,27720
202005,11710,서울특별시,송파구,40-44세,53315,25629,27686
202006,11710,서울특별시,송파구,40-44세,53416,25657,27759
202001,11710,서울특별시,송파구,45-49세,57417,27766,29651
202002,11710,서울특별시,송파구,45-49세,57234,27692,29542
202003,11710,서울특별시,송파구,45-49세,56866,27551,29315
202004,11710,서울특별시,송파구,45-49세,56686,27462,29224
202005,11710,서울특별시,송파구,45-49세,56537,27354,29183
202006,11710,서울특별시,송파구,45-49세,56380,27285,29095
202001,11710,서울특별시,송파구,50-54세,52796,25710,27086
202002,11710,서울특별시,송파구,50-54세,52772,25673,27099
202003,11710,서울특별시,송파구,50-54세,52633,25611,27022
202004,11710,서울특별시,송파구,50-54세,52650,25640,27010
202005,11710,서울특별시,송파구,50-54세,52753,25727,27026
202006,11710,서울특별시,송파구,50-54세,52802,25759,27043
202001,11710,서울특별시,송파구,55-59세,51614,24660,26954
202002,11710,서울특별시,송파구,55-59세,51506,24687,26819
202003,11710,서울특별시,송파구,55-59세,51353,24623,26730
202004,11710,서울특별시,송파구,55-59세,51120,24506,26614
202005,11710,서울특별시,송파구,55-59세,51008,24452,26556
202006,11710,서울특별시,송파구,55-59세,50670,24291,26379
202001,11710,서울특별시,송파구,60-64세,47806,22514,25292
202002,11710,서울특별시,송파구,60-64세,47731,22446,25285
202003,11710,서울특별시,송파구,60-64세,47477,22313,25164
202004,11710,서울특별시,송파구,60-64세,47459,22331,25128
202005,11710,서울특별시,송파구,60-64세,47374,22245,25129
202006,11710,서울특별시,송파구,60-64세,47586,22325,25261
202001,11710,서울특별시,송파구,65-69세,33155,15999,17156
202002,11710,서울특별시,송파구,65-69세,33521,16119,17402
202003,11710,서울특별시,송파구,65-69세,34014,16319,17695
202004,11710,서울특별시,송파구,65-69세,34195,16374,17821
202005,11710,서울특별시,송파구,65-69세,34425,16469,17956
202006,11710,서울특별시,송파구,65-69세,34581,16550,18031
202001,11710,서울특별시,송파구,70-74세,23502,11564,11938
202002,11710,서울특별시,송파구,70-74세,23577,11588,11989
202003,11710,서울특별시,송파구,70-74세,23691,11641,12050
202004,11710,서울특별시,송파구,70-74세,23702,11650,12052
202005,11710,서울특별시,송파구,70-74세,23769,11684,12085
202006,11710,서울특별시,송파구,70-74세,23892,11719,12173
202001,11710,서울특별시,송파구,75-79세,15196,7312,7884
202002,11710,서울특별시,송파구,75-79세,15268,7370,7898
202003,11710,서울특별시,송파구,75-79세,15342,7416,7926
202004,11710,서울특별시,송파구,75-79세,15387,7449,7938
202005,11710,서울특별시,송파구,75-79세,15488,7500,7988
202006,11710,서울특별시,송파구,75-79세,15574,7550,8024
202001,11710,서울특별시,송파구,80-84세,8887,3688,5199
202002,11710,서울특별시,송파구,80-84세,8907,3719,5188
202003,11710,서울특별시,송파구,80-84세,8955,3755,5200
202004,11710,서울특별시,송파구,80-84세,9004,3784,5220
202005,11710,서울특별시,송파구,80-84세,9037,3810,5227
202006,11710,서울특별시,송파구,80-84세,9031,3814,5217
202001,11710,서울특별시,송파구,85-89세,4565,1418,3147
202002,11710,서울특별시,송파구,85-89세,4599,1432,3167
202003,11710,서울특별시,송파구,85-89세,4634,1452,3182
202004,11710,서울특별시,송파구,85-89세,4681,1474,3207
202005,11710,서울특별시,송파구,85-89세,4705,1484,3221
202006,11710,서울특별시,송파구,85-89세,4728,1503,3225
202001,11710,서울특별시,송파구,90-94세,1861,448,1413
202002,11710,서울특별시,송파구,90-94세,1889,449,1440
202003,11710,서울특별시,송파구,90-94세,1913,451,1462
202004,11710,서울특별시,송파구,90-94세,1920,460,1460
202005,11710,서울특별시,송파구,90-94세,1924,464,1460
202006,11710,서울특별시,송파구,90-94세,1913,454,1459
202001,11710,서울특별시,송파구,95-99세,519,109,410
202002,11710,서울특별시,송파구,95-99세,521,108,413
202003,11710,서울특별시,송파구,95-99세,516,105,411
202004,11710,서울특별시,송파구,95-99세,516,108,408
202005,11710,서울특별시,송파구,95-99세,516,106,410
202006,11710,서울특별시,송파구,95-99세,511,107,404
202001,11710,서울특별시,송파구,100+,273,68,205
202002,11710,서울특별시,송파구,100+,276,68,208
202003,11710,서울특별시,송파구,100+,281,69,212
202004,11710,서울특별시,송파구,100+,283,69,214
202005,11710,서울특별시,송파구,100+,284,71,213
202006,11710,서울특별시,송파구,100+,285,72,213
202001,11740,서울특별시,강동구,0-4세,14783,7623,7160
202002,11740,서울특별시,강동구,0-4세,15147,7811,7336
202003,11740,서울특별시,강동구,0-4세,15549,8011,7538
202004,11740,서울특별시,강동구,0-4세,15590,8023,7567
202005,11740,서울특별시,강동구,0-4세,15559,8006,7553
202006,11740,서울특별시,강동구,0-4세,15503,7963,7540
202001,11740,서울특별시,강동구,5-9세,18042,9407,8635
202002,11740,서울특별시,강동구,5-9세,18693,9731,8962
202003,11740,서울특별시,강동구,5-9세,19166,9976,9190
202004,11740,서울특별시,강동구,5-9세,19297,10080,9217
202005,11740,서울특별시,강동구,5-9세,19343,10099,9244
202006,11740,서울특별시,강동구,5-9세,19373,10126,9247
202001,11740,서울특별시,강동구,10-14세,18049,9603,8446
202002,11740,서울특별시,강동구,10-14세,18556,9853,8703
202003,11740,서울특별시,강동구,10-14세,18739,9931,8808
202004,11740,서울특별시,강동구,10-14세,18833,9976,8857
202005,11740,서울특별시,강동구,10-14세,18917,10032,8885
202006,11740,서울특별시,강동구,10-14세,19016,10075,8941
202001,11740,서울특별시,강동구,15-19세,20858,10918,9940
202002,11740,서울특별시,강동구,15-19세,20871,10932,9939
202003,11740,서울특별시,강동구,15-19세,20855,10919,9936
202004,11740,서울특별시,강동구,15-19세,20748,10871,9877
202005,11740,서울특별시,강동구,15-19세,20600,10782,9818
202006,11740,서울특별시,강동구,15-19세,20486,10703,9783
202001,11740,서울특별시,강동구,20-24세,26498,13455,13043
202002,11740,서울특별시,강동구,20-24세,26616,13482,13134
202003,11740,서울특별시,강동구,20-24세,26866,13571,13295
202004,11740,서울특별시,강동구,20-24세,26987,13592,13395
202005,11740,서울특별시,강동구,20-24세,26974,13570,13404
202006,11740,서울특별시,강동구,20-24세,26980,13585,13395
202001,11740,서울특별시,강동구,25-29세,32907,16312,16595
202002,11740,서울특별시,강동구,25-29세,33163,16373,16790
202003,11740,서울특별시,강동구,25-29세,33732,16633,17099
202004,11740,서울특별시,강동구,25-29세,33974,16711,17263
202005,11740,서울특별시,강동구,25-29세,34186,16762,17424
202006,11740,서울특별시,강동구,25-29세,34348,16814,17534
202001,11740,서울특별시,강동구,30-34세,31592,15887,15705
202002,11740,서울특별시,강동구,30-34세,32123,16127,15996
202003,11740,서울특별시,강동구,30-34세,32650,16339,16311
202004,11740,서울특별시,강동구,30-34세,33055,16508,16547
202005,11740,서울특별시,강동구,30-34세,33205,16589,16616
202006,11740,서울특별시,강동구,30-34세,33355,16656,16699
202001,11740,서울특별시,강동구,35-39세,36878,18425,18453
202002,11740,서울특별시,강동구,35-39세,37491,18701,18790
202003,11740,서울특별시,강동구,35-39세,38062,18973,19089
202004,11740,서울특별시,강동구,35-39세,38255,19091,19164
202005,11740,서울특별시,강동구,35-39세,38404,19148,19256
202006,11740,서울특별시,강동구,35-39세,38437,19190,19247
202001,11740,서울특별시,강동구,40-44세,33980,16977,17003
202002,11740,서울특별시,강동구,40-44세,34950,17509,17441
202003,11740,서울특별시,강동구,40-44세,35598,17848,17750
202004,11740,서울특별시,강동구,40-44세,35767,17946,17821
202005,11740,서울특별시,강동구,40-44세,35921,18015,17906
202006,11740,서울특별시,강동구,40-44세,36057,18059,17998
202001,11740,서울특별시,강동구,45-49세,37007,18478,18529
202002,11740,서울특별시,강동구,45-49세,37393,18699,18694
202003,11740,서울특별시,강동구,45-49세,37602,18839,18763
202004,11740,서울특별시,강동구,45-49세,37646,18889,18757
202005,11740,서울특별시,강동구,45-49세,37581,18883,18698
202006,11740,서울특별시,강동구,45-49세,37547,18868,18679
202001,11740,서울특별시,강동구,50-54세,34950,17301,17649
202002,11740,서울특별시,강동구,50-54세,35260,17435,17825
202003,11740,서울특별시,강동구,50-54세,35588,17583,18005
202004,11740,서울특별시,강동구,50-54세,35782,17649,18133
202005,11740,서울특별시,강동구,50-54세,35926,17700,18226
202006,11740,서울특별시,강동구,50-54세,36024,17733,18291
202001,11740,서울특별시,강동구,55-59세,36470,17515,18955
202002,11740,서울특별시,강동구,55-59세,36697,17653,19044
202003,11740,서울특별시,강동구,55-59세,36981,17780,19201
202004,11740,서울특별시,강동구,55-59세,37044,17797,19247
202005,11740,서울특별시,강동구,55-59세,37049,17837,19212
202006,11740,서울특별시,강동구,55-59세,36750,17706,19044
202001,11740,서울특별시,강동구,60-64세,34628,16353,18275
202002,11740,서울특별시,강동구,60-64세,34926,16508,18418
202003,11740,서울특별시,강동구,60-64세,34984,16556,18428
202004,11740,서울특별시,강동구,60-64세,35229,16699,18530
202005,11740,서울특별시,강동구,60-64세,35393,16758,18635
202006,11740,서울특별시,강동구,60-64세,35670,16874,18796
202001,11740,서울특별시,강동구,65-69세,23774,11435,12339
202002,11740,서울특별시,강동구,65-69세,24187,11629,12558
202003,11740,서울특별시,강동구,65-69세,24935,11969,12966
202004,11740,서울특별시,강동구,65-69세,25217,12083,13134
202005,11740,서울특별시,강동구,65-69세,25433,12172,13261
202006,11740,서울특별시,강동구,65-69세,25598,12257,13341
202001,11740,서울특별시,강동구,70-74세,17321,8476,8845
202002,11740,서울특별시,강동구,70-74세,17510,8520,8990
202003,11740,서울특별시,강동구,70-74세,17735,8619,9116
202004,11740,서울특별시,강동구,70-74세,17844,8669,9175
202005,11740,서울특별시,강동구,70-74세,17906,8696,9210
202006,11740,서울특별시,강동구,70-74세,17983,8739,9244
202001,11740,서울특별시,강동구,75-79세,11346,5398,5948
202002,11740,서울특별시,강동구,75-79세,11459,5471,5988
202003,11740,서울특별시,강동구,75-79세,11587,5543,6044
202004,11740,서울특별시,강동구,75-79세,11648,5592,6056
202005,11740,서울특별시,강동구,75-79세,11768,5664,6104
202006,11740,서울특별시,강동구,75-79세,11850,5686,6164
202001,11740,서울특별시,강동구,80-84세,6559,2622,3937
202002,11740,서울특별시,강동구,80-84세,6602,2657,3945
202003,11740,서울특별시,강동구,80-84세,6674,2708,3966
202004,11740,서울특별시,강동구,80-84세,6737,2739,3998
202005,11740,서울특별시,강동구,80-84세,6744,2743,4001
202006,11740,서울특별시,강동구,80-84세,6748,2749,3999
202001,11740,서울특별시,강동구,85-89세,3184,926,2258
202002,11740,서울특별시,강동구,85-89세,3247,933,2314
202003,11740,서울특별시,강동구,85-89세,3317,951,2366
202004,11740,서울특별시,강동구,85-89세,3333,961,2372
202005,11740,서울특별시,강동구,85-89세,3343,967,2376
202006,11740,서울특별시,강동구,85-89세,3364,977,2387
202001,11740,서울특별시,강동구,90-94세,1369,296,1073
202002,11740,서울특별시,강동구,90-94세,1392,300,1092
202003,11740,서울특별시,강동구,90-94세,1419,302,1117
202004,11740,서울특별시,강동구,90-94세,1436,305,1131
202005,11740,서울특별시,강동구,90-94세,1442,305,1137
202006,11740,서울특별시,강동구,90-94세,1455,304,1151
202001,11740,서울특별시,강동구,95-99세,369,80,289
202002,11740,서울특별시,강동구,95-99세,368,79,289
202003,11740,서울특별시,강동구,95-99세,367,77,290
202004,11740,서울특별시,강동구,95-99세,377,78,299
202005,11740,서울특별시,강동구,95-99세,375,79,296
202006,11740,서울특별시,강동구,95-99세,379,80,299
202001,11740,서울특별시,강동구,100+,231,58,173
202002,11740,서울특별시,강동구,100+,236,61,175
202003,11740,서울특별시,강동구,100+,240,61,179
202004,11740,서울특별시,강동구,100+,243,62,181
202005,11740,서울특별시,강동구,100+,243,62,181
202006,11740,서울특별시,강동구,100+,241,62,179
